Town Code,Town,Year,2010 Census Units,Government Assisted,Tenant Rental Assistance, Single Family CHFA/ USDA Mortgages,Deed Restricted Units,Total Assisted Units,Percent Affordable
1,Andover,2020,1317,18,1,32,0,51,3.87
2,Ansonia,2020,8148,349,764,147,0,1260,15.46
3,Ashford,2020,1903,32,0,36,0,68,3.57
4,Avon,2020,7389,244,16,44,0,304,4.11
5,Barkhamsted,2020,1589,0,6,23,0,29,1.83
6,Beacon Falls,2020,2509,0,4,46,0,50,1.99
7,Berlin,2020,8140,556,50,142,4,752,9.24
8,Bethany,2020,2044,0,2,13,0,15,0.73
9,Bethel,2020,7310,192,26,154,87,459,6.28
10,Bethlehem,2020,1575,24,0,9,0,33,2.10
11,Bloomfield,2020,9019,558,106,341,0,1005,11.14
12,Bolton,2020,2015,0,2,28,0,30,1.49
13,Bozrah,2020,1059,0,3,30,0,33,3.12
14,Branford,2020,13972,233,77,170,9,489,3.50
15,Bridgeport,2020,57012,6505,4353,900,19,11777,20.66
16,Bridgewater,2020,881,0,24,1,0,25,2.84
17,Bristol,2020,27011,1908,962,1124,0,3994,14.79
18,Brookfield,2020,6562,155,27,110,77,369,5.62
19,Brooklyn,2020,3235,189,9,65,0,263,8.13
20,Burlington,2020,3389,27,0,47,0,74,2.18
21,Canaan,2020,779,1,4,5,1,11,1.41
22,Canterbury,2020,2043,76,1,68,0,145,7.10
23,Canton,2020,4339,211,15,53,32,311,7.17
24,Chaplin,2020,988,0,1,37,0,38,3.85
25,Cheshire,2020,10424,258,22,100,17,397,3.81
26,Chester,2020,1923,23,3,16,0,42,2.18
27,Clinton,2020,6065,105,8,66,0,179,2.95
28,Colchester,2020,6182,364,38,146,4,552,8.93
29,Colebrook,2020,722,0,1,7,1,9,1.25
30,Columbia,2020,2308,24,2,62,0,88,3.81
31,Cornwall,2020,1007,28,2,6,0,36,3.57
32,Coventry,2020,5099,103,5,131,20,259,5.08
33,Cromwell,2020,6001,212,11,198,0,421,7.02
34,Danbury,2020,31154,1615,1269,565,289,3738,12.00
35,Darien,2020,7074,136,10,2,104,252,3.56
36,Deep River,2020,2096,26,6,32,0,64,3.05
37,Derby,2020,5849,275,301,111,0,687,11.75
38,Durham,2020,2694,36,1,28,0,65,2.41
40,East Granby,2020,2152,72,2,48,0,122,5.67
41,East Haddam,2020,4508,73,3,63,0,139,3.08
42,East Hampton,2020,5485,70,6,91,25,192,3.50
43,East Hartford,2020,21328,1593,815,1035,0,3443,16.14
44,East Haven,2020,12533,542,168,302,0,1012,8.07
45,East Lyme,2020,8458,396,20,95,19,530,6.27
47,East Windsor,2020,5045,559,42,116,0,717,14.21
39,Eastford,2020,793,0,0,15,0,15,1.89
46,Easton,2020,2715,0,0,3,15,18,0.66
48,Ellington,2020,6665,260,5,118,0,383,5.75
49,Enfield,2020,17558,1340,227,659,7,2233,12.72
50,Essex,2020,3261,58,2,17,16,93,2.85
51,Fairfield,2020,21648,231,131,70,124,556,2.57
52,Farmington,2020,11106,470,107,149,155,881,7.93
53,Franklin,2020,771,27,2,20,0,49,6.36
54,Glastonbury,2020,13656,604,44,133,2,783,5.73
55,Goshen,2020,1664,1,1,5,0,7,0.42
56,Granby,2020,4360,85,2,51,5,143,3.28
57,Greenwich,2020,25631,879,443,16,33,1371,5.35
58,Griswold,2020,5118,137,54,158,0,349,6.82
59,Groton,2020,17978,3727,107,377,10,4221,23.48
60,Guilford,2020,9596,186,10,34,0,230,2.40
61,Haddam,2020,3504,22,1,31,0,54,1.54
62,Hamden,2020,25114,937,788,523,4,2252,8.97
63,Hampton,2020,793,0,1,11,0,12,1.51
64,Hartford,2020,51822,10501,8635,1523,0,20659,39.87
65,Hartland,2020,856,2,0,8,0,10,1.17
66,Harwinton,2020,2282,22,5,36,5,68,2.98
67,Hebron,2020,3567,56,3,51,0,110,3.08
68,Kent,2020,1665,58,4,5,0,67,4.02
69,Killingly,2020,7592,520,147,188,0,855,11.26
70,Killingworth,2020,2598,0,0,18,5,23,0.89
71,Lebanon,2020,3125,26,3,84,0,113,3.62
72,Ledyard,2020,5987,32,8,233,0,273,4.56
73,Lisbon,2020,1730,2,0,59,0,61,3.53
74,Litchfield,2020,3975,140,2,28,19,189,4.75
75,Lyme,2020,1223,0,0,5,8,13,1.06
76,Madison,2020,8049,90,2,11,33,136,1.69
77,Manchester,2020,25996,1851,950,964,32,3797,14.61
78,Mansfield,2020,6017,175,124,96,2,397,6.60
79,Marlborough,2020,2389,24,0,24,0,48,2.01
80,Meriden,2020,25892,1964,1270,1029,11,4274,16.51
81,Middlebury,2020,2892,77,5,25,20,127,4.39
82,Middlefield,2020,1863,30,3,21,1,55,2.95
83,Middletown,2020,21223,3019,1123,543,25,4710,22.19
84,Milford,2020,23074,726,208,192,74,1200,5.20
85,Monroe,2020,6918,35,3,54,8,100,1.45
86,Montville,2020,7407,81,58,267,0,406,5.48
87,Morris,2020,1314,20,4,8,0,32,2.44
88,Naugatuck,2020,13061,493,315,367,0,1175,9.00
89,New Britain,2020,31226,2913,1583,1167,100,5763,18.46
90,New Canaan,2020,7551,175,21,5,21,222,2.94
91,New Fairfield,2020,5593,0,1,67,17,85,1.52
92,New Hartford,2020,2923,12,4,55,15,86,2.94
93,New Haven,2020,54967,9511,6867,982,440,17800,32.38
95,New London,2020,11840,1598,510,509,101,2718,22.96
96,New Milford,2020,11731,307,44,182,17,550,4.69
94,Newington,2020,13011,531,122,479,36,1168,8.98
97,Newtown,2020,10061,134,7,95,32,268,2.66
98,Norfolk,2020,967,21,2,5,0,28,2.90
99,North Branford,2020,5629,62,13,52,0,127,2.26
100,North Canaan,2020,1587,148,0,14,0,162,10.21
101,North Haven,2020,9491,393,53,97,23,566,5.96
102,North Stonington,2020,2306,0,1,27,6,34,1.47
103,Norwalk,2020,35415,2242,1468,437,635,4782,13.50
104,Norwich,2020,18659,2249,794,567,0,3610,19.35
105,Old Lyme,2020,5021,60,2,20,3,85,1.69
106,Old Saybrook,2020,5602,50,15,25,73,163,2.91
107,Orange,2020,5345,46,9,12,6,73,1.37
108,Oxford,2020,4746,36,2,31,0,69,1.45
109,Plainfield,2020,6229,377,190,224,0,791,12.70
110,Plainville,2020,8063,205,41,306,22,574,7.12
111,Plymouth,2020,5109,178,21,196,0,395,7.73
112,Pomfret,2020,1684,32,5,13,0,50,2.97
113,Portland,2020,4077,185,94,70,0,349,8.56
114,Preston,2020,2019,40,7,40,0,87,4.31
115,Prospect,2020,3474,0,6,56,0,62,1.78
116,Putnam,2020,4299,383,64,77,0,524,12.19
117,Redding,2020,3811,0,1,17,0,18,0.47
118,Ridgefield,2020,9420,175,7,36,69,287,3.05
119,Rocky Hill,2020,8843,235,52,194,0,481,5.44
120,Roxbury,2020,1167,19,0,5,0,24,2.06
121,Salem,2020,1635,0,3,34,0,37,2.26
122,Salisbury,2020,2593,24,2,2,14,42,1.62
123,Scotland,2020,680,0,1,31,0,32,4.71
124,Seymour,2020,6968,262,28,113,0,403,5.78
125,Sharon,2020,1775,32,1,3,0,36,2.03
126,Shelton,2020,16146,254,45,137,82,518,3.21
127,Sherman,2020,1831,0,1,7,0,8,0.44
128,Simsbury,2020,9123,289,60,98,0,447,4.90
129,Somers,2020,3479,146,9,35,0,190,5.46
132,South Windsor,2020,10243,443,55,232,9,739,7.21
130,Southbury,2020,9091,90,6,41,0,137,1.51
131,Southington,2020,17447,499,63,354,51,967,5.54
133,Sprague,2020,1248,20,13,27,1,61,4.89
134,Stafford,2020,5124,257,22,127,0,406,7.92
135,Stamford,2020,50573,4225,1971,450,1270,7916,15.65
136,Sterling,2020,1511,0,7,24,0,31,2.05
137,Stonington,2020,9467,441,16,97,0,554,5.85
138,Stratford,2020,21091,524,460,373,33,1390,6.59
139,Suffield,2020,5469,296,5,51,15,367,6.71
140,Thomaston,2020,3276,104,6,98,0,208,6.35
141,Thompson,2020,4171,151,13,48,0,212,5.08
142,Tolland,2020,5451,127,5,103,3,238,4.37
143,Torrington,2020,16761,908,322,547,17,1794,10.70
144,Trumbull,2020,13157,315,19,97,303,734,5.58
145,Union,2020,388,0,0,5,0,5,1.29
146,Vernon,2020,13896,1509,461,386,12,2368,17.04
147,Voluntown,2020,1127,20,1,24,0,45,3.99
148,Wallingford,2020,18945,354,129,328,35,846,4.47
149,Warren,2020,811,0,0,1,0,1,0.12
150,Washington,2020,2124,14,2,4,23,43,2.02
151,Waterbury,2020,47991,5344,3123,1751,21,10239,21.34
152,Waterford,2020,8634,123,30,266,0,419,4.85
153,Watertown,2020,9096,205,32,229,0,466,5.12
155,West Hartford,2020,26396,643,854,372,250,2119,8.03
156,West Haven,2020,22446,1024,1868,439,0,3331,14.84
154,Westbrook,2020,3937,140,5,30,29,204,5.18
157,Weston,2020,3674,0,2,6,0,8,0.22
158,Westport,2020,10399,265,60,4,58,387,3.72
159,Wethersfield,2020,11677,705,114,293,0,1112,9.52
160,Willington,2020,2637,160,5,37,0,202,7.66
161,Wilton,2020,6475,158,6,17,51,232,3.58
162,Winchester,2020,5613,350,167,92,0,609,10.85
163,Windham,2020,9570,1763,617,363,0,2743,28.66
164,Windsor,2020,11767,154,258,453,26,891,7.57
165,Windsor Locks,2020,5429,297,156,243,0,696,12.82
166,Wolcott,2020,6276,313,9,184,0,506,8.06
167,Woodbridge,2020,3478,30,8,6,0,44,1.27
168,Woodbury,2020,4564,60,3,28,0,91,1.99
169,Woodstock,2020,3582,24,0,32,0,56,1.56
1,Andover,2019,1317,18,1,29,0,48,3.64
2,Ansonia,2019,8148,349,752,140,9,1250,15.34
3,Ashford,2019,1903,32,0,35,0,67,3.52
4,Avon,2019,7389,244,13,43,0,300,4.06
5,Barkhamsted,2019,1589,0,6,20,0,26,1.64
6,Beacon Falls,2019,2509,0,3,46,0,49,1.95
7,Berlin,2019,8140,556,54,138,10,758,9.31
8,Bethany,2019,2044,0,2,12,0,14,0.68
9,Bethel,2019,7310,152,27,157,78,414,5.66
10,Bethlehem,2019,1575,24,1,9,0,34,2.16
11,Bloomfield,2019,9019,558,99,341,0,998,11.07
12,Bolton,2019,2015,0,1,28,0,29,1.44
13,Bozrah,2019,1059,0,3,30,0,33,3.12
14,Branford,2019,13972,233,60,176,0,469,3.36
15,Bridgeport,2019,57012,6395,4301,916,19,11631,20.40
16,Bridgewater,2019,881,0,0,1,0,1,0.11
17,Bristol,2019,27011,1908,884,1102,0,3894,14.42
18,Brookfield,2019,6562,155,23,111,77,366,5.58
19,Brooklyn,2019,3235,189,9,70,0,268,8.28
20,Burlington,2019,3389,27,0,44,0,71,2.10
21,Canaan,2019,779,1,4,4,1,10,1.28
22,Canterbury,2019,2043,76,1,64,0,141,6.90
23,Canton,2019,4339,211,17,49,32,309,7.12
24,Chaplin,2019,988,0,0,36,0,36,3.64
25,Cheshire,2019,10424,258,22,97,17,394,3.78
26,Chester,2019,1923,23,3,16,0,42,2.18
27,Clinton,2019,6065,105,8,58,0,171,2.82
28,Colchester,2019,6182,364,35,146,4,549,8.88
29,Colebrook,2019,722,0,1,6,1,8,1.11
30,Columbia,2019,2308,24,2,63,0,89,3.86
31,Cornwall,2019,1007,28,2,3,0,33,3.28
32,Coventry,2019,5099,103,5,133,20,261,5.12
33,Cromwell,2019,6001,212,8,197,0,417,6.95
34,Danbury,2019,31154,1590,1254,571,296,3711,11.91
35,Darien,2019,7074,136,11,2,104,253,3.58
36,Deep River,2019,2096,26,5,30,0,61,2.91
37,Derby,2019,5849,275,281,110,0,666,11.39
38,Durham,2019,2694,36,1,27,0,64,2.38
40,East Granby,2019,2152,72,1,43,0,116,5.39
41,East Haddam,2019,4508,73,5,59,0,137,3.04
42,East Hampton,2019,5485,70,5,86,25,186,3.39
43,East Hartford,2019,21328,1592,869,1030,0,3491,16.37
44,East Haven,2019,12533,542,152,313,0,1007,8.03
45,East Lyme,2019,8458,396,20,90,19,525,6.21
47,East Windsor,2019,5045,559,43,105,0,707,14.01
39,Eastford,2019,793,0,0,16,0,16,2.02
46,Easton,2019,2715,0,0,2,15,17,0.63
48,Ellington,2019,6665,260,5,107,0,372,5.58
49,Enfield,2019,17558,1340,219,652,7,2218,12.63
50,Essex,2019,3261,58,4,21,16,99,3.04
51,Fairfield,2019,21648,231,115,63,126,535,2.47
52,Farmington,2019,11106,470,107,143,155,875,7.88
53,Franklin,2019,771,27,1,16,0,44,5.71
54,Glastonbury,2019,13656,604,44,131,2,781,5.72
55,Goshen,2019,1664,1,0,4,0,5,0.30
56,Granby,2019,4360,85,1,47,5,138,3.17
57,Greenwich,2019,25631,863,459,16,33,1371,5.35
58,Griswold,2019,5118,137,53,165,0,355,6.94
59,Groton,2019,17978,3727,99,376,10,4212,23.43
60,Guilford,2019,9596,186,10,35,0,231,2.41
61,Haddam,2019,3504,22,1,27,0,50,1.43
62,Hamden,2019,25114,937,725,512,4,2178,8.67
63,Hampton,2019,793,0,1,13,0,14,1.77
64,Hartford,2019,51822,10394,8474,1514,0,20382,39.33
65,Hartland,2019,856,2,0,4,0,6,0.70
66,Harwinton,2019,2282,22,4,33,0,59,2.59
67,Hebron,2019,3567,56,3,44,0,103,2.89
68,Kent,2019,1665,58,4,5,0,67,4.02
69,Killingly,2019,7592,520,147,201,0,868,11.43
70,Killingworth,2019,2598,0,0,19,5,24,0.92
71,Lebanon,2019,3125,26,3,83,0,112,3.58
72,Ledyard,2019,5987,32,7,225,0,264,4.41
73,Lisbon,2019,1730,2,0,60,0,62,3.58
74,Litchfield,2019,3975,140,2,25,19,186,4.68
75,Lyme,2019,1223,0,0,4,8,12,0.98
76,Madison,2019,8049,90,2,11,33,136,1.69
77,Manchester,2019,25996,1851,962,964,32,3809,14.65
78,Mansfield,2019,6017,175,130,100,2,407,6.76
79,Marlborough,2019,2389,24,1,27,0,52,2.18
80,Meriden,2019,25892,1962,1249,1038,11,4260,16.45
81,Middlebury,2019,2892,77,4,26,20,127,4.39
82,Middlefield,2019,1863,30,3,19,1,53,2.84
83,Middletown,2019,21223,3019,1068,520,25,4632,21.83
84,Milford,2019,23074,726,227,199,74,1226,5.31
85,Monroe,2019,6918,32,2,54,8,96,1.39
86,Montville,2019,7407,81,54,259,0,394,5.32
87,Morris,2019,1314,20,4,7,0,31,2.36
88,Naugatuck,2019,13061,493,317,349,0,1159,8.87
89,New Britain,2019,31226,2913,1550,1151,117,5731,18.35
90,New Canaan,2019,7551,175,22,4,21,222,2.94
91,New Fairfield,2019,5593,0,4,63,17,84,1.50
92,New Hartford,2019,2923,12,7,54,15,88,3.01
93,New Haven,2019,54967,9407,6721,1009,478,17615,32.05
95,New London,2019,11840,1598,507,502,96,2703,22.83
96,New Milford,2019,11731,307,42,172,17,538,4.59
94,Newington,2019,13011,531,116,472,36,1155,8.88
97,Newtown,2019,10061,134,9,98,26,267,2.65
98,Norfolk,2019,967,21,2,4,0,27,2.79
99,North Branford,2019,5629,62,12,51,0,125,2.22
100,North Canaan,2019,1587,148,1,14,0,163,10.27
101,North Haven,2019,9491,343,57,93,23,516,5.44
102,North Stonington,2019,2306,0,0,29,6,35,1.52
103,Norwalk,2019,35415,2169,1425,427,636,4657,13.15
104,Norwich,2019,18659,2221,789,562,0,3572,19.14
105,Old Lyme,2019,5021,60,1,18,3,82,1.63
106,Old Saybrook,2019,5602,50,10,22,73,155,2.77
107,Orange,2019,5345,46,8,13,6,73,1.37
108,Oxford,2019,4746,36,4,32,0,72,1.52
109,Plainfield,2019,6229,377,173,228,0,778,12.49
110,Plainville,2019,8063,205,53,298,22,578,7.17
111,Plymouth,2019,5109,178,16,195,0,389,7.61
112,Pomfret,2019,1684,32,2,13,0,47,2.79
113,Portland,2019,4077,185,88,73,0,346,8.49
114,Preston,2019,2019,40,6,40,0,86,4.26
115,Prospect,2019,3474,0,7,52,0,59,1.70
116,Putnam,2019,4299,383,64,84,0,531,12.35
117,Redding,2019,3811,0,1,17,0,18,0.47
118,Ridgefield,2019,9420,175,6,34,69,284,3.01
119,Rocky Hill,2019,8843,235,45,195,0,475,5.37
120,Roxbury,2019,1167,19,0,5,0,24,2.06
121,Salem,2019,1635,0,2,30,0,32,1.96
122,Salisbury,2019,2593,24,2,2,14,42,1.62
123,Scotland,2019,680,0,1,25,0,26,3.82
124,Seymour,2019,6968,262,29,114,0,405,5.81
125,Sharon,2019,1775,32,1,2,0,35,1.97
126,Shelton,2019,16146,254,46,124,82,506,3.13
127,Sherman,2019,1831,0,1,7,0,8,0.44
128,Simsbury,2019,9123,289,50,93,0,432,4.74
129,Somers,2019,3479,146,7,33,0,186,5.35
132,South Windsor,2019,10243,443,52,228,9,732,7.15
130,Southbury,2019,9091,90,5,39,0,134,1.47
131,Southington,2019,17447,499,69,329,51,948,5.43
133,Sprague,2019,1248,20,13,29,1,63,5.05
134,Stafford,2019,5124,257,25,125,0,407,7.94
135,Stamford,2019,50573,4210,1913,434,1270,7827,15.48
136,Sterling,2019,1511,0,7,29,0,36,2.38
137,Stonington,2019,9467,441,24,96,0,561,5.93
138,Stratford,2019,21091,524,424,366,33,1347,6.39
139,Suffield,2019,5469,296,3,50,15,364,6.66
140,Thomaston,2019,3276,104,7,91,0,202,6.17
141,Thompson,2019,4171,151,14,51,0,216,5.18
142,Tolland,2019,5451,90,2,95,3,190,3.49
143,Torrington,2019,16761,908,406,538,17,1869,11.15
144,Trumbull,2019,13157,315,20,92,189,616,4.68
145,Union,2019,388,0,0,5,0,5,1.29
146,Vernon,2019,13896,1509,439,383,12,2343,16.86
147,Voluntown,2019,1127,20,1,27,0,48,4.26
148,Wallingford,2019,18945,354,123,309,35,821,4.33
149,Warren,2019,811,0,0,1,0,1,0.12
150,Washington,2019,2124,14,3,4,23,44,2.07
151,Waterbury,2019,47991,5344,3290,1787,21,10442,21.76
152,Waterford,2019,8634,123,35,257,0,415,4.81
153,Watertown,2019,9096,205,29,218,0,452,4.97
155,West Hartford,2019,26396,643,837,361,250,2091,7.92
156,West Haven,2019,22446,1024,1756,456,0,3236,14.42
154,Westbrook,2019,3937,140,5,28,29,202,5.13
157,Weston,2019,3674,0,2,6,0,8,0.22
158,Westport,2019,10399,265,59,3,50,377,3.63
159,Wethersfield,2019,11677,705,111,287,0,1103,9.45
160,Willington,2019,2637,160,4,35,0,199,7.55
161,Wilton,2019,6475,158,6,15,52,231,3.57
162,Winchester,2019,5613,349,168,90,0,607,10.81
163,Windham,2019,9570,1763,594,368,0,2725,28.47
164,Windsor,2019,11767,154,269,436,26,885,7.52
165,Windsor Locks,2019,5429,137,162,234,0,533,9.82
166,Wolcott,2019,6276,313,9,174,0,496,7.90
167,Woodbridge,2019,3478,30,8,5,0,43,1.24
168,Woodbury,2019,4564,60,3,29,0,92,2.02
169,Woodstock,2019,3582,24,0,33,0,57,1.59
1,Andover,2018,1317,18,2,25,0,45,3.42
2,Ansonia,2018,8148,347,747,134,9,1237,15.18
3,Ashford,2018,1903,32,0,32,0,64,3.36
4,Avon,2018,7389,244,13,34,0,291,3.94
5,Barkhamsted,2018,1589,0,6,16,0,22,1.38
6,Beacon Falls,2018,2509,0,3,40,0,43,1.71
7,Berlin,2018,8140,556,59,126,10,751,9.23
8,Bethany,2018,2044,0,2,9,1,12,0.59
9,Bethel,2018,7310,192,28,134,74,428,5.85
10,Bethlehem,2018,1575,24,0,8,0,32,2.03
11,Bloomfield,2018,9019,558,95,328,0,981,10.88
12,Bolton,2018,2015,0,1,25,0,26,1.29
13,Bozrah,2018,1059,0,4,28,0,32,3.02
14,Branford,2018,13972,233,63,152,0,448,3.21
15,Bridgeport,2018,57012,6434,4240,900,19,11593,20.33
16,Bridgewater,2018,881,0,0,1,0,1,0.11
17,Bristol,2018,27011,1766,815,1025,0,3606,13.35
18,Brookfield,2018,6562,155,24,96,77,352,5.36
19,Brooklyn,2018,3235,231,8,72,0,311,9.61
20,Burlington,2018,3389,27,0,37,0,64,1.89
21,Canaan,2018,779,35,4,5,1,45,5.78
22,Canterbury,2018,2043,76,1,56,0,133,6.51
23,Canton,2018,4339,211,14,47,32,304,7.01
24,Chaplin,2018,988,0,0,32,0,32,3.24
25,Cheshire,2018,10424,258,22,87,17,384,3.68
26,Chester,2018,1923,23,3,13,0,39,2.03
27,Clinton,2018,6065,105,12,52,0,169,2.79
28,Colchester,2018,6182,364,30,129,4,527,8.52
29,Colebrook,2018,722,0,1,5,1,7,0.97
30,Columbia,2018,2308,24,2,58,0,84,3.64
31,Cornwall,2018,1007,28,2,3,0,33,3.28
32,Coventry,2018,5099,103,4,120,20,247,4.84
33,Cromwell,2018,6001,212,9,185,0,406,6.77
34,Danbury,2018,31154,1590,943,544,296,3373,10.83
35,Darien,2018,7074,136,10,2,104,252,3.56
36,Deep River,2018,2096,26,5,29,0,60,2.86
37,Derby,2018,5849,275,302,96,0,673,11.51
38,Durham,2018,2694,36,1,17,0,54,2.00
40,East Granby,2018,2152,72,3,40,0,115,5.34
41,East Haddam,2018,4508,73,5,48,0,126,2.80
42,East Hampton,2018,5485,70,7,75,25,177,3.23
43,East Hartford,2018,21328,1574,776,989,0,3339,15.66
44,East Haven,2018,12533,542,154,302,0,998,7.96
45,East Lyme,2018,8458,396,0,82,19,497,5.88
47,East Windsor,2018,5045,559,40,102,14,715,14.17
39,Eastford,2018,793,0,0,15,0,15,1.89
46,Easton,2018,2715,0,0,1,15,16,0.59
48,Ellington,2018,6665,260,7,96,0,363,5.45
49,Enfield,2018,17558,1340,219,613,7,2179,12.41
50,Essex,2018,3261,58,5,16,16,95,2.91
51,Fairfield,2018,21648,230,105,52,140,527,2.43
52,Farmington,2018,11106,470,118,132,155,875,7.88
53,Franklin,2018,771,27,1,15,0,43,5.58
54,Glastonbury,2018,13656,582,38,117,2,739,5.41
55,Goshen,2018,1664,1,0,3,0,4,0.24
56,Granby,2018,4360,85,1,44,5,135,3.10
57,Greenwich,2018,25631,865,392,13,27,1297,5.06
58,Griswold,2018,5118,137,49,156,0,342,6.68
59,Groton,2018,17978,3587,94,358,10,4049,22.52
60,Guilford,2018,9596,186,11,32,0,229,2.39
61,Haddam,2018,3504,22,0,27,0,49,1.40
62,Hamden,2018,25114,937,699,486,4,2126,8.47
63,Hampton,2018,793,0,1,13,0,14,1.77
64,Hartford,2018,51822,10293,8267,1479,0,20039,38.67
65,Hartland,2018,856,2,0,4,0,6,0.70
66,Harwinton,2018,2282,22,4,25,0,51,2.23
67,Hebron,2018,3567,58,3,39,0,100,2.80
68,Kent,2018,1665,34,4,4,0,42,2.52
69,Killingly,2018,7592,520,112,202,0,834,10.99
70,Killingworth,2018,2598,0,0,20,5,25,0.96
71,Lebanon,2018,3125,26,4,75,0,105,3.36
72,Ledyard,2018,5987,32,9,206,0,247,4.13
73,Lisbon,2018,1730,2,0,48,0,50,2.89
74,Litchfield,2018,3975,140,4,24,19,187,4.70
75,Lyme,2018,1223,0,19,4,8,31,2.53
76,Madison,2018,8049,90,2,7,33,132,1.64
77,Manchester,2018,25996,1831,932,896,32,3691,14.20
78,Mansfield,2018,6017,175,128,99,2,404,6.71
79,Marlborough,2018,2389,24,1,26,0,51,2.13
80,Meriden,2018,25892,1887,1168,1011,11,4077,15.75
81,Middlebury,2018,2892,76,5,22,20,123,4.25
82,Middlefield,2018,1863,30,3,17,1,51,2.74
83,Middletown,2018,21223,3019,1163,484,25,4691,22.10
84,Milford,2018,23074,726,225,192,76,1219,5.28
85,Monroe,2018,6918,32,4,49,8,93,1.34
86,Montville,2018,7407,81,53,234,0,368,4.97
87,Morris,2018,1314,20,4,5,0,29,2.21
88,Naugatuck,2018,13061,493,292,328,0,1113,8.52
89,New Britain,2018,31226,2911,1477,1107,177,5672,18.16
90,New Canaan,2018,7551,215,21,3,21,260,3.44
91,New Fairfield,2018,5593,0,2,60,18,80,1.43
92,New Hartford,2018,2923,12,5,49,15,81,2.77
93,New Haven,2018,54967,9434,6600,1008,481,17523,31.88
95,New London,2018,11840,1592,483,486,99,2660,22.47
96,New Milford,2018,11731,307,35,150,17,509,4.34
94,Newington,2018,13011,530,115,435,36,1116,8.58
97,Newtown,2018,10061,134,8,88,18,248,2.46
98,Norfolk,2018,967,11,2,3,0,16,1.65
99,North Branford,2018,5629,62,14,45,4,125,2.22
100,North Canaan,2018,1587,138,1,13,0,152,9.58
101,North Haven,2018,9491,343,53,88,23,507,5.34
102,North Stonington,2018,2306,0,1,25,6,32,1.39
103,Norwalk,2018,35415,2215,1331,363,607,4516,12.75
104,Norwich,2018,18659,2221,745,528,0,3494,18.73
105,Old Lyme,2018,5021,60,2,16,3,81,1.61
106,Old Saybrook,2018,5602,50,11,19,58,138,2.46
107,Orange,2018,5345,46,9,12,6,73,1.37
108,Oxford,2018,4746,36,5,31,0,72,1.52
109,Plainfield,2018,6229,377,186,221,0,784,12.59
110,Plainville,2018,8063,205,32,277,22,536,6.65
111,Plymouth,2018,5109,178,16,170,0,364,7.12
112,Pomfret,2018,1684,32,2,13,0,47,2.79
113,Portland,2018,4077,185,85,68,0,338,8.29
114,Preston,2018,2019,40,6,39,0,85,4.21
115,Prospect,2018,3474,0,7,45,0,52,1.50
116,Putnam,2018,4299,383,62,84,0,529,12.31
117,Redding,2018,3811,0,1,13,0,14,0.37
118,Ridgefield,2018,9420,175,6,29,69,279,2.96
119,Rocky Hill,2018,8843,235,42,173,0,450,5.09
120,Roxbury,2018,1167,19,0,5,0,24,2.06
121,Salem,2018,1635,3,2,27,0,32,1.96
122,Salisbury,2018,2593,16,2,2,13,33,1.27
123,Scotland,2018,680,0,0,22,0,22,3.24
124,Seymour,2018,6968,262,34,105,0,401,5.75
125,Sharon,2018,1775,32,2,2,0,36,2.03
126,Shelton,2018,16146,254,47,120,82,503,3.12
127,Sherman,2018,1831,0,1,6,0,7,0.38
128,Simsbury,2018,9123,289,55,83,0,427,4.68
129,Somers,2018,3479,146,5,30,0,181,5.20
132,South Windsor,2018,10243,427,51,208,9,695,6.79
130,Southbury,2018,9091,89,6,34,0,129,1.42
131,Southington,2018,17447,499,71,317,51,938,5.38
133,Sprague,2018,1248,20,11,32,1,64,5.13
134,Stafford,2018,5124,257,8,119,0,384,7.49
135,Stamford,2018,50573,4112,1879,385,1272,7648,15.12
136,Sterling,2018,1511,0,6,29,0,35,2.32
137,Stonington,2018,9467,441,23,91,0,555,5.86
138,Stratford,2018,21091,524,453,333,33,1343,6.37
139,Suffield,2018,5469,248,2,48,15,313,5.72
140,Thomaston,2018,3276,104,7,80,0,191,5.83
141,Thompson,2018,4171,151,12,54,0,217,5.20
142,Tolland,2018,5451,90,3,81,3,177,3.25
143,Torrington,2018,16761,928,329,512,17,1786,10.66
144,Trumbull,2018,13157,315,19,78,180,592,4.50
145,Union,2018,388,0,0,5,0,5,1.29
146,Vernon,2018,13896,1508,401,372,12,2293,16.50
147,Voluntown,2018,1127,20,2,23,0,45,3.99
148,Wallingford,2018,18945,354,120,280,35,789,4.16
149,Warren,2018,811,0,0,0,0,0,0.00
150,Washington,2018,2124,14,3,4,23,44,2.07
151,Waterbury,2018,47991,5344,2916,1758,28,10046,20.93
152,Waterford,2018,8634,123,23,240,0,386,4.47
153,Watertown,2018,9096,205,24,196,0,425,4.67
155,West Hartford,2018,26396,587,788,332,261,1968,7.46
156,West Haven,2018,22446,1024,1499,442,0,2965,13.21
154,Westbrook,2018,3937,140,6,26,29,201,5.11
157,Weston,2018,3674,0,2,5,0,7,0.19
158,Westport,2018,10399,265,55,3,27,350,3.37
159,Wethersfield,2018,11677,705,108,264,0,1077,9.22
160,Willington,2018,2637,160,3,33,0,196,7.43
161,Wilton,2018,6475,158,5,14,82,259,4.00
162,Winchester,2018,5613,349,183,86,0,618,11.01
163,Windham,2018,9570,1763,610,360,0,2733,28.56
164,Windsor,2018,11767,154,218,408,26,806,6.85
165,Windsor Locks,2018,5429,137,138,214,0,489,9.01
166,Wolcott,2018,6276,313,8,153,0,474,7.55
167,Woodbridge,2018,3478,30,8,5,0,43,1.24
168,Woodbury,2018,4564,59,2,24,0,85,1.86
169,Woodstock,2018,3582,24,0,33,0,57,1.59
1,Andover,2017,1317,18,0,24,0,42,3.19
2,Ansonia,2017,8148,347,696,118,9,1170,14.36
3,Ashford,2017,1903,32,1,32,0,65,3.42
4,Avon,2017,7389,244,10,33,0,287,3.88
5,Barkhamsted,2017,1589,0,7,16,0,23,1.45
6,Beacon Falls,2017,2509,0,3,37,0,40,1.59
7,Berlin,2017,8140,556,53,110,10,729,8.96
8,Bethany,2017,2044,0,2,9,1,12,0.59
9,Bethel,2017,7310,152,26,117,69,364,4.98
10,Bethlehem,2017,1575,24,0,5,0,29,1.84
11,Bloomfield,2017,9019,558,88,315,0,961,10.66
12,Bolton,2017,2015,0,2,26,0,28,1.39
13,Bozrah,2017,1059,0,4,32,0,36,3.40
14,Branford,2017,13972,243,65,144,0,452,3.24
15,Bridgeport,2017,57012,6311,4259,891,19,11480,20.14
16,Bridgewater,2017,881,0,0,3,0,3,0.34
17,Bristol,2017,27011,1908,868,996,0,3772,13.96
18,Brookfield,2017,6562,155,24,81,77,337,5.14
19,Brooklyn,2017,3235,231,10,100,0,341,10.54
20,Burlington,2017,3389,27,0,36,0,63,1.86
21,Canaan,2017,779,35,4,13,1,53,6.80
22,Canterbury,2017,2043,76,1,66,0,143,7.00
23,Canton,2017,4339,211,16,50,32,309,7.12
24,Chaplin,2017,988,,0,35,0,35,3.54
25,Cheshire,2017,10424,258,20,76,17,371,3.56
26,Chester,2017,1923,23,3,14,0,40,2.08
27,Clinton,2017,6065,84,13,43,0,140,2.31
28,Colchester,2017,6182,364,37,137,0,538,8.70
29,Colebrook,2017,722,0,1,6,1,8,1.11
30,Columbia,2017,2308,40,2,60,0,102,4.42
31,Cornwall,2017,1007,28,2,4,0,34,3.38
32,Coventry,2017,5099,103,4,130,20,257,5.04
33,Cromwell,2017,6001,212,7,171,0,390,6.50
34,Danbury,2017,31154,1592,1011,497,296,3396,10.90
35,Darien,2017,7074,136,8,1,104,249,3.52
36,Deep River,2017,2096,26,6,23,0,55,2.62
37,Derby,2017,5849,274,315,88,0,677,11.57
38,Durham,2017,2694,36,0,15,0,51,1.89
40,East Granby,2017,2152,72,2,36,0,110,5.11
41,East Haddam,2017,4508,73,4,40,0,117,2.60
42,East Hampton,2017,5485,70,6,77,25,178,3.25
43,East Hartford,2017,21328,1573,851,936,0,3360,15.75
44,East Haven,2017,12533,542,139,284,0,965,7.70
45,East Lyme,2017,8458,396,18,84,19,517,6.11
47,East Windsor,2017,5045,559,38,108,14,719,14.25
39,Eastford,2017,793,0,0,16,0,16,2.02
46,Easton,2017,2715,0,0,1,16,17,0.63
48,Ellington,2017,6665,260,7,97,0,364,5.46
49,Enfield,2017,17558,1340,226,582,7,2155,12.27
50,Essex,2017,3261,58,3,13,0,74,2.27
51,Fairfield,2017,21648,218,108,49,112,487,2.25
52,Farmington,2017,11106,470,114,125,155,864,7.78
53,Franklin,2017,771,27,1,21,0,49,6.36
54,Glastonbury,2017,13656,582,42,107,2,733,5.37
55,Goshen,2017,1664,1,1,4,0,6,0.36
56,Granby,2017,4360,85,2,43,5,135,3.10
57,Greenwich,2017,25631,865,383,12,27,1287,5.02
58,Griswold,2017,5118,148,54,186,0,388,7.58
59,Groton,2017,17978,3587,108,340,10,4045,22.50
60,Guilford,2017,9596,186,8,34,0,228,2.38
61,Haddam,2017,3504,22,0,27,0,49,1.40
62,Hamden,2017,25114,937,659,456,4,2056,8.19
63,Hampton,2017,793,0,1,25,0,26,3.28
64,Hartford,2017,51822,10044,8354,1477,0,19875,38.35
65,Hartland,2017,856,2,0,3,0,5,0.58
66,Harwinton,2017,2282,22,4,29,0,55,2.41
67,Hebron,2017,3567,58,3,38,0,99,2.78
68,Kent,2017,1665,53,5,6,0,64,3.84
69,Killingly,2017,7592,520,117,296,0,933,12.29
70,Killingworth,2017,2598,0,0,23,5,28,1.08
71,Lebanon,2017,3125,26,3,85,0,114,3.65
72,Ledyard,2017,5987,32,9,204,0,245,4.09
73,Lisbon,2017,1730,2,0,55,0,57,3.29
74,Litchfield,2017,3975,140,6,26,19,191,4.81
75,Lyme,2017,1223,0,0,2,8,10,0.82
76,Madison,2017,8049,90,3,8,29,130,1.62
77,Manchester,2017,25996,1830,936,854,34,3654,14.06
78,Mansfield,2017,6017,175,133,106,2,416,6.91
79,Marlborough,2017,2389,24,2,23,0,49,2.05
80,Meriden,2017,25892,2027,1163,956,11,4157,16.06
81,Middlebury,2017,2892,76,4,22,20,122,4.22
82,Middlefield,2017,1863,30,3,14,1,48,2.58
83,Middletown,2017,21223,3019,1057,473,25,4574,21.55
84,Milford,2017,23074,726,233,188,87,1234,5.35
85,Monroe,2017,6918,32,4,43,1,80,1.16
86,Montville,2017,7407,81,50,247,0,378,5.10
87,Morris,2017,1314,20,4,5,0,29,2.21
88,Naugatuck,2017,13061,493,299,317,0,1109,8.49
89,New Britain,2017,31226,2911,1522,1074,256,5763,18.46
90,New Canaan,2017,7551,163,18,2,23,206,2.73
91,New Fairfield,2017,5593,0,4,56,18,78,1.39
92,New Hartford,2017,2923,12,7,48,15,82,2.81
93,New Haven,2017,54967,9432,6357,1019,656,17464,31.77
95,New London,2017,11840,1710,448,466,110,2734,23.09
96,New Milford,2017,11731,236,35,147,17,435,3.71
94,Newington,2017,13011,530,109,403,36,1078,8.29
97,Newtown,2017,10061,134,8,76,15,233,2.32
98,Norfolk,2017,967,28,3,5,0,36,3.72
99,North Branford,2017,5629,62,14,49,4,129,2.29
100,North Canaan,2017,1587,138,1,9,0,148,9.33
101,North Haven,2017,9491,341,56,85,0,482,5.08
102,North Stonington,2017,2306,0,1,28,6,35,1.52
103,Norwalk,2017,35415,2240,1275,335,656,4506,12.72
104,Norwich,2017,18659,2225,787,502,0,3514,18.83
105,Old Lyme,2017,5021,60,2,14,3,79,1.57
106,Old Saybrook,2017,5602,50,9,16,58,133,2.37
107,Orange,2017,5345,46,9,12,6,73,1.37
108,Oxford,2017,4746,36,5,30,0,71,1.50
109,Plainfield,2017,6229,316,186,286,0,788,12.65
110,Plainville,2017,8063,205,52,261,22,540,6.70
111,Plymouth,2017,5109,178,13,192,0,383,7.50
112,Pomfret,2017,1684,32,2,16,0,50,2.97
113,Portland,2017,4077,185,85,68,0,338,8.29
114,Preston,2017,2019,40,7,41,0,88,4.36
115,Prospect,2017,3474,0,7,44,0,51,1.47
116,Putnam,2017,4299,383,68,115,0,566,13.17
117,Redding,2017,3811,0,1,11,0,12,0.31
118,Ridgefield,2017,9420,179,5,28,64,276,2.93
119,Rocky Hill,2017,8843,235,36,159,0,430,4.86
120,Roxbury,2017,1167,19,0,3,0,22,1.89
121,Salem,2017,1635,3,2,24,0,29,1.77
122,Salisbury,2017,2593,16,2,2,13,33,1.27
123,Scotland,2017,680,0,0,21,0,21,3.09
124,Seymour,2017,6968,262,27,109,0,398,5.71
125,Sharon,2017,1775,32,2,2,0,36,2.03
126,Shelton,2017,16146,253,45,103,82,483,2.99
127,Sherman,2017,1831,0,2,8,0,10,0.55
128,Simsbury,2017,9123,289,58,76,0,423,4.64
129,Somers,2017,3479,146,4,32,0,182,5.23
132,South Windsor,2017,10243,427,50,201,0,678,6.62
130,Southbury,2017,9091,89,7,30,0,126,1.39
131,Southington,2017,17447,502,73,294,51,920,5.27
133,Sprague,2017,1248,20,15,36,1,72,5.77
134,Stafford,2017,5124,257,13,141,0,411,8.02
135,Stamford,2017,50573,4736,1864,357,1274,8231,16.28
136,Sterling,2017,1511,0,5,35,0,40,2.65
137,Stonington,2017,9467,440,22,77,0,539,5.69
138,Stratford,2017,21091,524,446,306,33,1309,6.21
139,Suffield,2017,5469,212,3,49,15,279,5.10
140,Thomaston,2017,3276,104,6,86,0,196,5.98
141,Thompson,2017,4171,151,15,75,0,241,5.78
142,Tolland,2017,5451,89,3,77,3,172,3.16
143,Torrington,2017,16761,908,395,493,17,1813,10.82
144,Trumbull,2017,13157,315,22,73,224,634,4.82
145,Union,2017,388,0,0,4,0,4,1.03
146,Vernon,2017,13896,1508,404,353,12,2277,16.39
147,Voluntown,2017,1127,20,3,26,0,49,4.35
148,Wallingford,2017,18945,354,125,269,35,783,4.13
149,Warren,2017,811,0,0,1,0,1,0.12
150,Washington,2017,2124,14,4,7,23,48,2.26
151,Waterbury,2017,47991,5272,3143,1761,172,10348,21.56
152,Waterford,2017,8634,123,19,235,0,377,4.37
153,Watertown,2017,9096,205,25,184,0,414,4.55
155,West Hartford,2017,26396,587,816,320,268,1991,7.54
156,West Haven,2017,22446,1024,1505,431,0,2960,13.19
154,Westbrook,2017,3937,140,7,22,29,198,5.03
157,Weston,2017,3674,0,1,3,0,4,0.11
158,Westport,2017,10399,293,54,4,20,371,3.57
159,Wethersfield,2017,11677,733,114,255,0,1102,9.44
160,Willington,2017,2637,160,4,35,0,199,7.55
161,Wilton,2017,6475,159,5,10,83,257,3.97
162,Winchester,2017,5613,348,206,124,0,678,12.08
163,Windham,2017,9570,1767,609,417,0,2793,29.18
164,Windsor,2017,11767,154,228,389,26,797,6.77
165,Windsor Locks,2017,5429,137,162,190,0,489,9.01
166,Wolcott,2017,6276,312,9,133,0,454,7.23
167,Woodbridge,2017,3478,30,7,5,0,42,1.21
168,Woodbury,2017,4564,59,3,24,0,86,1.88
169,Woodstock,2017,3582,24,0,48,0,72,2.01
1,Andover,2016,1317,18,0,22,0,40,3.04
2,Ansonia,2016,8148,347,658,104,9,1118,13.72
3,Ashford,2016,1903,32,2,33,0,67,3.52
4,Avon,2016,7389,244,8,31,0,283,3.83
5,Barkhamsted,2016,1589,0,7,13,0,20,1.26
6,Beacon Falls,2016,2509,0,3,34,0,37,1.47
7,Berlin,2016,8140,556,47,102,10,715,8.78
8,Bethany,2016,2044,0,2,7,1,10,0.49
9,Bethel,2016,7310,152,22,98,69,341,4.66
10,Bethlehem,2016,1575,24,0,4,0,28,1.78
11,Bloomfield,2016,9019,591,93,292,0,976,10.82
12,Bolton,2016,2015,0,2,18,0,20,0.99
13,Bozrah,2016,1059,0,3,30,0,33,3.12
14,Branford,2016,13972,243,63,145,0,451,3.23
15,Bridgeport,2016,57012,6279,4102,900,19,11300,19.82
16,Bridgewater,2016,881,0,0,4,0,4,0.45
17,Bristol,2016,27011,1916,844,931,0,3691,13.66
18,Brookfield,2016,6562,83,22,74,77,256,3.90
19,Brooklyn,2016,3235,231,12,103,0,346,10.70
20,Burlington,2016,3389,42,0,30,0,72,2.12
21,Canaan,2016,779,35,5,15,1,56,7.19
22,Canterbury,2016,2043,76,1,62,0,139,6.80
23,Canton,2016,4339,211,15,46,32,304,7.01
24,Chaplin,2016,988,0,0,33,0,33,3.34
25,Cheshire,2016,10424,259,20,69,17,365,3.50
26,Chester,2016,1923,23,3,14,0,40,2.08
27,Clinton,2016,6065,84,16,34,0,134,2.21
28,Colchester,2016,6182,364,40,120,0,524,8.48
29,Colebrook,2016,722,0,0,7,1,8,1.11
30,Columbia,2016,2308,40,2,56,0,98,4.25
31,Cornwall,2016,1007,28,2,3,0,33,3.28
32,Coventry,2016,5099,108,4,117,20,249,4.88
33,Cromwell,2016,6001,212,7,161,0,380,6.33
34,Danbury,2016,31154,1588,926,468,296,3278,10.52
35,Darien,2016,7074,136,6,1,98,241,3.41
36,Deep River,2016,2096,26,3,20,0,49,2.34
37,Derby,2016,5849,274,316,76,0,666,11.39
38,Durham,2016,2694,36,0,10,0,46,1.71
40,East Granby,2016,2152,72,0,38,0,110,5.11
41,East Haddam,2016,4508,73,3,23,0,99,2.20
42,East Hampton,2016,5485,70,6,75,25,176,3.21
43,East Hartford,2016,21328,1576,859,904,0,3339,15.66
44,East Haven,2016,12533,542,140,266,0,948,7.56
45,East Lyme,2016,8458,396,16,77,19,508,6.01
47,East Windsor,2016,5045,559,34,99,14,706,13.99
39,Eastford,2016,793,0,0,18,0,18,2.27
46,Easton,2016,2715,0,0,1,15,16,0.59
48,Ellington,2016,6665,260,5,97,0,362,5.43
49,Enfield,2016,17558,1340,217,540,7,2104,11.98
50,Essex,2016,3261,36,3,10,0,49,1.50
51,Fairfield,2016,21648,218,108,43,112,481,2.22
52,Farmington,2016,11106,470,108,118,155,851,7.66
53,Franklin,2016,771,27,0,22,0,49,6.36
54,Glastonbury,2016,13656,582,36,107,2,727,5.32
55,Goshen,2016,1664,1,1,5,0,7,0.42
56,Granby,2016,4360,85,1,41,5,132,3.03
57,Greenwich,2016,25631,856,338,11,54,1259,4.91
58,Griswold,2016,5118,148,58,174,0,380,7.42
59,Groton,2016,17978,3587,103,326,10,4026,22.39
60,Guilford,2016,9596,186,7,32,0,225,2.34
61,Haddam,2016,3504,22,0,30,0,52,1.48
62,Hamden,2016,25114,935,635,432,4,2006,7.99
63,Hampton,2016,793,0,1,27,0,28,3.53
64,Hartford,2016,51822,9972,8439,1428,0,19839,38.28
65,Hartland,2016,856,2,0,3,0,5,0.58
66,Harwinton,2016,2282,22,4,29,0,55,2.41
67,Hebron,2016,3567,58,3,33,0,94,2.64
68,Kent,2016,1665,53,5,4,0,62,3.72
69,Killingly,2016,7592,520,112,297,0,929,12.24
70,Killingworth,2016,2598,0,0,18,5,23,0.89
71,Lebanon,2016,3125,26,4,74,0,104,3.33
72,Ledyard,2016,5987,32,8,186,0,226,3.77
73,Lisbon,2016,1730,2,0,49,0,51,2.95
74,Litchfield,2016,3975,140,7,22,19,188,4.73
75,Lyme,2016,1223,0,0,2,8,10,0.82
76,Madison,2016,8049,90,3,8,29,130,1.62
77,Manchester,2016,25996,1850,890,826,34,3600,13.85
78,Mansfield,2016,6017,417,123,99,2,641,10.65
79,Marlborough,2016,2389,24,2,22,0,48,2.01
80,Meriden,2016,25892,2027,1103,936,11,4077,15.75
81,Middlebury,2016,2892,76,4,14,20,114,3.94
82,Middlefield,2016,1863,30,4,11,1,46,2.47
83,Middletown,2016,21223,3019,1035,445,25,4524,21.32
84,Milford,2016,23074,726,220,179,87,1212,5.25
85,Monroe,2016,6918,32,3,33,1,69,1.00
86,Montville,2016,7407,81,45,223,0,349,4.71
87,Morris,2016,1314,20,3,2,0,25,1.90
88,Naugatuck,2016,13061,493,270,287,0,1050,8.04
89,New Britain,2016,31226,2901,1478,1054,256,5689,18.22
90,New Canaan,2016,7551,163,13,2,23,201,2.66
91,New Fairfield,2016,5593,0,4,47,21,72,1.29
92,New Hartford,2016,2923,12,8,45,15,80,2.74
93,New Haven,2016,54967,9055,5709,1029,639,16432,29.89
95,New London,2016,11840,1713,449,449,106,2717,22.95
96,New Milford,2016,11731,268,23,129,16,436,3.72
94,Newington,2016,13011,530,108,384,36,1058,8.13
97,Newtown,2016,10061,134,6,63,15,218,2.17
98,Norfolk,2016,967,28,3,5,0,36,3.72
99,North Branford,2016,5629,62,14,46,4,126,2.24
100,North Canaan,2016,1587,138,0,8,0,146,9.20
101,North Haven,2016,9491,341,47,79,0,467,4.92
102,North Stonington,2016,2306,0,2,28,4,34,1.47
103,Norwalk,2016,35415,2224,1277,299,701,4501,12.71
104,Norwich,2016,18659,2225,784,484,0,3493,18.72
105,Old Lyme,2016,5021,60,2,8,3,73,1.45
106,Old Saybrook,2016,5602,50,9,13,20,92,1.64
107,Orange,2016,5345,46,6,13,6,71,1.33
108,Oxford,2016,4746,36,5,27,0,68,1.43
109,Plainfield,2016,6229,377,177,283,0,837,13.44
110,Plainville,2016,8063,205,48,249,22,524,6.50
111,Plymouth,2016,5109,178,11,187,0,376,7.36
112,Pomfret,2016,1684,32,2,14,0,48,2.85
113,Portland,2016,4077,185,84,66,0,335,8.22
114,Preston,2016,2019,40,8,37,0,85,4.21
115,Prospect,2016,3474,0,6,39,0,45,1.30
116,Putnam,2016,4299,383,67,112,0,562,13.07
117,Redding,2016,3811,0,0,9,0,9,0.24
118,Ridgefield,2016,9420,179,5,26,59,269,2.86
119,Rocky Hill,2016,8843,235,31,148,0,414,4.68
120,Roxbury,2016,1167,19,0,3,0,22,1.89
121,Salem,2016,1635,3,2,23,0,28,1.71
122,Salisbury,2016,2593,16,1,1,13,31,1.20
123,Scotland,2016,680,0,0,17,0,17,2.50
124,Seymour,2016,6968,262,23,97,0,382,5.48
125,Sharon,2016,1775,32,3,2,0,37,2.08
126,Shelton,2016,16146,253,38,97,82,470,2.91
127,Sherman,2016,1831,0,2,6,0,8,0.44
128,Simsbury,2016,9123,289,61,59,0,409,4.48
129,Somers,2016,3479,146,7,30,0,183,5.26
132,South Windsor,2016,10243,427,50,185,0,662,6.46
130,Southbury,2016,9091,89,7,29,0,125,1.37
131,Southington,2016,17447,502,49,266,51,868,4.98
133,Sprague,2016,1248,20,14,36,0,70,5.61
134,Stafford,2016,5124,257,13,135,0,405,7.90
135,Stamford,2016,50573,4744,1753,332,1274,8103,16.02
136,Sterling,2016,1511,0,7,33,0,40,2.65
137,Stonington,2016,9467,382,16,60,0,458,4.84
138,Stratford,2016,21091,524,421,281,33,1259,5.97
139,Suffield,2016,5469,212,2,47,15,276,5.05
140,Thomaston,2016,3276,104,6,76,0,186,5.68
141,Thompson,2016,4171,151,16,79,0,246,5.90
142,Tolland,2016,5451,89,3,66,3,161,2.95
143,Torrington,2016,16761,908,390,495,17,1810,10.80
144,Trumbull,2016,13157,315,15,58,210,598,4.55
145,Union,2016,388,0,0,4,0,4,1.03
146,Vernon,2016,13896,1440,399,329,12,2180,15.69
147,Voluntown,2016,1127,20,3,26,0,49,4.35
148,Wallingford,2016,18945,354,116,253,35,758,4.00
149,Warren,2016,811,0,0,1,0,1,0.12
150,Washington,2016,2124,14,5,10,23,52,2.45
151,Waterbury,2016,47991,5257,2969,1800,172,10198,21.25
152,Waterford,2016,8634,123,20,219,0,362,4.19
153,Watertown,2016,9096,205,23,159,0,387,4.25
155,West Hartford,2016,26396,587,786,287,268,1928,7.30
156,West Haven,2016,22446,1024,1476,411,0,2911,12.97
154,Westbrook,2016,3937,140,8,18,29,195,4.95
157,Weston,2016,3674,0,1,2,0,3,0.08
158,Westport,2016,10399,246,54,4,20,324,3.12
159,Wethersfield,2016,11677,615,99,231,0,945,8.09
160,Willington,2016,2637,160,4,33,0,197,7.47
161,Wilton,2016,6475,136,8,10,104,258,3.98
162,Winchester,2016,5613,348,187,121,0,656,11.69
163,Windham,2016,9570,1747,608,416,0,2771,28.96
164,Windsor,2016,11767,154,221,368,26,769,6.54
165,Windsor Locks,2016,5429,137,147,176,0,460,8.47
166,Wolcott,2016,6276,312,7,124,0,443,7.06
167,Woodbridge,2016,3478,30,6,5,0,41,1.18
168,Woodbury,2016,4564,59,3,22,0,84,1.84
169,Woodstock,2016,3582,24,1,49,0,74,2.07
1,Andover,2015,1317,24,0,31,0,55,4.18
2,Ansonia,2015,8148,371,654,125,9,1159,14.22
3,Ashford,2015,1903,32,2,45,0,79,4.15
4,Avon,2015,7389,244,7,32,0,283,3.83
5,Barkhamsted,2015,1589,0,5,15,0,20,1.26
6,Beacon Falls,2015,2509,0,3,38,0,41,1.63
7,Berlin,2015,8140,556,43,110,10,719,8.83
8,Bethany,2015,2044,0,1,5,1,7,0.34
9,Bethel,2015,7310,212,15,80,63,370,5.06
10,Bethlehem,2015,1575,24,0,2,0,26,1.65
11,Bloomfield,2015,9019,591,90,328,0,1009,11.19
12,Bolton,2015,2015,0,2,23,0,25,1.24
12,Bolton,2015,2015,0,3,20,0,23,1.14
13,Bozrah,2015,1059,0,2,31,0,33,3.12
14,Branford,2015,13972,231,60,193,0,484,3.46
15,Bridgeport,2015,57012,6275,3983,1062,19,11339,19.89
16,Bridgewater,2015,881,0,0,4,0,4,0.45
17,Bristol,2015,27011,1913,780,1147,0,3840,14.22
18,Brookfield,2015,6562,83,8,60,70,221,3.37
19,Brooklyn,2015,3235,231,11,116,0,358,11.07
20,Burlington,2015,3389,27,0,39,0,66,1.95
21,Canaan,2015,779,35,2,16,1,54,6.93
22,Canterbury,2015,2043,76,1,62,0,139,6.80
23,Canton,2015,4339,211,14,71,32,328,7.56
24,Chaplin,2015,988,0,0,32,0,32,3.24
25,Cheshire,2015,10424,277,16,85,17,395,3.79
26,Chester,2015,1923,23,3,14,0,40,2.08
27,Clinton,2015,6065,84,13,46,0,143,2.36
28,Colchester,2015,6182,364,34,133,0,531,8.59
29,Colebrook,2015,722,0,0,8,1,9,1.25
30,Columbia,2015,2308,40,3,61,0,104,4.51
31,Cornwall,2015,1007,28,2,4,0,34,3.38
32,Coventry,2015,5099,103,3,173,20,299,5.86
33,Cromwell,2015,6001,212,9,231,0,452,7.53
34,Danbury,2015,31154,1588,909,414,296,3207,10.29
35,Darien,2015,7074,136,6,1,95,238,3.36
36,Deep River,2015,2096,26,2,26,0,54,2.58
37,Derby,2015,5849,275,322,77,0,674,11.52
38,Durham,2015,2694,36,1,15,0,52,1.93
40,East Granby,2015,2152,72,1,40,0,113,5.25
41,East Haddam,2015,4508,73,3,38,0,114,2.53
42,East Hampton,2015,5485,70,8,100,25,203,3.70
43,East Hartford,2015,21328,1700,759,1024,0,3483,16.33
44,East Haven,2015,12533,542,139,339,0,1020,8.14
45,East Lyme,2015,8458,396,12,107,19,534,6.31
47,East Windsor,2015,5045,559,33,130,14,736,14.59
39,Eastford,2015,793,0,0,23,0,23,2.90
46,Easton,2015,2715,0,0,0,15,15,0.55
48,Ellington,2015,6665,260,5,117,0,382,5.73
49,Enfield,2015,17558,1340,199,648,7,2194,12.50
50,Essex,2015,3261,36,5,9,0,50,1.53
51,Fairfield,2015,21648,241,104,46,112,503,2.32
52,Farmington,2015,11106,496,107,143,155,901,8.11
53,Franklin,2015,771,27,0,21,0,48,6.23
54,Glastonbury,2015,13656,583,33,141,2,759,5.56
55,Goshen,2015,1664,1,1,7,0,9,0.54
56,Granby,2015,4360,85,1,51,5,142,3.26
57,Greenwich,2015,25631,969,337,3,54,1363,5.32
58,Griswold,2015,5118,148,74,209,0,431,8.42
59,Groton,2015,17978,3588,93,385,10,4076,22.67
60,Guilford,2015,9596,186,7,40,0,233,2.43
61,Haddam,2015,3504,22,0,20,0,42,1.20
62,Hamden,2015,25114,902,554,529,4,1989,7.92
63,Hampton,2015,793,0,1,36,0,37,4.67
64,Hartford,2015,51822,10697,8532,1621,0,20850,40.23
65,Hartland,2015,856,2,0,7,0,9,1.05
66,Harwinton,2015,2282,22,2,35,0,59,2.59
67,Hebron,2015,3567,58,2,44,0,104,2.92
68,Kent,2015,1665,53,4,4,0,61,3.66
69,Killingly,2015,7592,527,106,417,0,1050,13.83
70,Killingworth,2015,2598,0,0,15,5,20,0.77
71,Lebanon,2015,3125,26,4,79,0,109,3.49
72,Ledyard,2015,5987,32,6,222,0,260,4.34
73,Lisbon,2015,1730,2,0,58,0,60,3.47
74,Litchfield,2015,3975,140,5,22,29,196,4.93
75,Lyme,2015,1223,0,0,2,8,10,0.82
76,Madison,2015,8049,90,2,9,29,130,1.62
77,Manchester,2015,25996,1878,839,1013,34,3764,14.48
78,Mansfield,2015,6017,417,121,111,2,651,10.82
79,Marlborough,2015,2389,24,2,24,0,50,2.09
80,Meriden,2015,25892,2027,1102,1128,11,4268,16.48
83,Middletown,2015,21223,3142,1121,655,25,4943,23.29
84,Milford,2015,23074,726,211,242,87,1266,5.49
85,Monroe,2015,6918,32,3,29,1,65,0.94
86,Montville,2015,7407,81,37,257,0,375,5.06
87,Morris,2015,1314,20,4,1,0,25,1.90
88,Naugatuck,2015,13061,537,260,337,0,1134,8.68
89,New Britain,2015,31226,3331,1423,1271,256,6281,20.11
90,New Canaan,2015,7551,163,10,3,23,199,2.64
91,New Fairfield,2015,5593,0,1,38,13,52,0.93
92,New Hartford,2015,2923,12,6,46,15,79,2.70
93,New Haven,2015,54967,9124,5654,1240,602,16620,30.24
95,New London,2015,11840,1709,449,517,102,2777,23.45
96,New Milford,2015,11731,307,24,151,16,498,4.25
94,Newington,2015,13011,531,104,453,36,1124,8.64
97,Newtown,2015,10061,134,3,43,15,195,1.94
98,Norfolk,2015,967,28,3,6,0,37,3.83
99,North Branford,2015,5629,62,11,63,0,136,2.42
100,North Canaan,2015,1587,138,1,10,0,149,9.39
101,North Haven,2015,9491,343,40,91,0,474,4.99
102,North Stonington,2015,2306,0,2,29,0,31,1.34
103,Norwalk,2015,35415,2328,1065,304,666,4363,12.32
104,Norwich,2015,18659,2225,762,589,0,3576,19.17
105,Old Lyme,2015,5021,60,3,9,3,75,1.49
106,Old Saybrook,2015,5602,50,7,20,20,97,1.73
107,Orange,2015,5345,46,6,13,6,71,1.33
108,Oxford,2015,4746,36,4,18,0,58,1.22
109,Plainfield,2015,6229,377,180,382,0,939,15.07
110,Plainville,2015,8063,242,22,332,22,618,7.66
111,Plymouth,2015,5109,178,10,210,0,398,7.79
112,Pomfret,2015,1684,32,1,22,0,55,3.27
113,Portland,2015,4077,185,83,73,0,341,8.36
114,Preston,2015,2019,40,5,45,0,90,4.46
115,Prospect,2015,3474,0,4,38,0,42,1.21
116,Putnam,2015,4299,383,65,170,0,618,14.38
117,Redding,2015,3811,0,0,1,0,1,0.03
118,Ridgefield,2015,9420,179,3,15,59,256,2.72
119,Rocky Hill,2015,8843,235,25,194,0,454,5.13
120,Roxbury,2015,1167,19,0,2,0,21,1.80
121,Salem,2015,1635,1,0,31,0,32,1.96
122,Salisbury,2015,2593,16,2,5,12,35,1.35
123,Scotland,2015,680,0,0,17,0,17,2.50
124,Seymour,2015,6968,262,21,113,0,396,5.68
125,Sharon,2015,1775,20,2,4,0,26,1.46
126,Shelton,2015,16146,344,42,103,82,571,3.54
127,Sherman,2015,1831,0,2,4,0,6,0.33
128,Simsbury,2015,9123,241,19,79,0,339,3.72
129,Somers,2015,3479,146,10,33,0,189,5.43
130,Southbury,2015,9091,90,6,25,0,121,1.33
133,Sprague,2015,1248,20,13,39,0,72,5.77
134,Stafford,2015,5124,257,10,205,0,472,9.21
135,Stamford,2015,50573,5031,1836,361,1274,8502,16.81
136,Sterling,2015,1511,0,6,44,0,50,3.31
137,Stonington,2015,9467,383,16,72,0,471,4.98
138,Stratford,2015,21091,524,392,311,33,1260,5.97
139,Suffield,2015,5469,212,2,68,15,297,5.43
140,Thomaston,2015,3276,104,4,118,0,226,6.90
141,Thompson,2015,4171,151,11,112,0,274,6.57
142,Tolland,2015,5451,96,3,89,3,191,3.50
143,Torrington,2015,16761,1112,316,668,17,2113,12.61
144,Trumbull,2015,13157,315,16,47,210,588,4.47
145,Union,2015,388,0,0,10,0,10,2.58
146,Vernon,2015,13896,1470,371,411,12,2264,16.29
147,Voluntown,2015,1127,20,4,30,0,54,4.79
148,Wallingford,2015,18945,481,116,337,35,969,5.11
149,Warren,2015,811,0,0,5,0,5,0.62
150,Washington,2015,2124,14,5,4,23,46,2.17
151,Waterbury,2015,47991,5561,2904,2429,172,11066,23.06
152,Waterford,2015,8634,123,21,259,0,403,4.67
153,Watertown,2015,9096,205,22,167,0,394,4.33
155,West Hartford,2015,26396,621,720,357,283,1981,7.50
156,West Haven,2015,22446,1024,1438,468,0,2930,13.05
154,Westbrook,2015,3937,140,7,17,24,188,4.78
157,Weston,2015,3674,0,1,2,0,3,0.08
158,Westport,2015,10399,246,50,3,20,319,3.07
159,Wethersfield,2015,11677,615,96,278,0,989,8.47
160,Willington,2015,2637,160,1,47,0,208,7.89
161,Wilton,2015,6475,136,6,8,104,254,3.92
162,Winchester,2015,5613,348,214,161,0,723,12.88
163,Windham,2015,9570,1862,596,534,0,2992,31.26
164,Windsor,2015,11767,154,207,437,26,824,7.00
165,Windsor Locks,2015,5429,137,140,209,0,486,8.95
166,Wolcott,2015,6276,313,5,153,0,471,7.50
167,Woodbridge,2015,3478,30,5,6,0,41,1.18
168,Woodbury,2015,4564,59,3,26,0,88,1.93
169,Woodstock,2015,3582,24,2,72,0,98,2.74
1,Andover,2014,1317,24,1,32,0,57,4.33
2,Ansonia,2014,8148,371,642,112,9,1134,13.92
3,Ashford,2014,1903,32,2,50,0,84,4.41
4,Avon,2014,7389,244,8,26,0,278,3.76
5,Barkhamsted,2014,1589,0,4,13,0,17,1.07
6,Beacon Falls,2014,2509,0,2,31,0,33,1.32
7,Berlin,2014,8140,556,43,94,6,699,8.59
8,Bethany,2014,2044,0,0,2,1,3,0.15
9,Bethel,2014,7310,252,15,66,64,397,5.43
10,Bethlehem,2014,1575,24,0,1,0,25,1.59
11,Bloomfield,2014,9019,591,149,311,0,1051,11.65
12,Bolton,2014,2015,0,3,23,0,26,1.29
13,Bozrah,2014,1059,0,2,34,0,36,3.40
14,Branford,2014,13972,243,56,179,0,478,3.42
15,Bridgeport,2014,57012,5870,3779,1036,20,10705,18.78
16,Bridgewater,2014,881,0,0,2,0,2,0.23
17,Bristol,2014,27011,1633,823,1065,0,3521,13.04
18,Brookfield,2014,6562,35,7,48,70,160,2.44
19,Brooklyn,2014,3235,231,12,135,0,378,11.68
20,Burlington,2014,3389,27,0,34,0,61,1.80
21,Canaan,2014,779,25,3,30,1,59,7.57
22,Canterbury,2014,2043,76,0,79,0,155,7.59
23,Canton,2014,4339,211,17,68,32,328,7.56
24,Chaplin,2014,988,0,0,36,0,36,3.64
25,Cheshire,2014,10424,277,12,78,17,384,3.68
26,Chester,2014,1923,23,3,12,0,38,1.98
27,Clinton,2014,6065,84,9,47,0,140,2.31
28,Colchester,2014,6182,364,34,145,0,543,8.78
29,Colebrook,2014,722,0,0,10,1,11,1.52
30,Columbia,2014,2308,24,3,63,0,90,3.90
31,Cornwall,2014,1007,18,2,3,0,23,2.28
32,Coventry,2014,5099,103,1,176,20,300,5.88
33,Cromwell,2014,6001,212,13,203,0,428,7.13
34,Danbury,2014,31154,1587,904,344,296,3131,10.05
35,Darien,2014,7074,136,7,1,95,239,3.38
36,Deep River,2014,2096,26,24,26,0,76,3.63
37,Derby,2014,5849,275,314,69,0,658,11.25
38,Durham,2014,2694,36,4,14,0,54,2.00
40,East Granby,2014,2152,72,2,35,0,109,5.07
41,East Haddam,2014,4508,73,1,47,1,122,2.71
42,East Hampton,2014,5485,70,5,98,25,198,3.61
43,East Hartford,2014,21328,1700,1054,952,0,3706,17.38
44,East Haven,2014,12533,542,141,307,0,990,7.90
45,East Lyme,2014,8458,396,10,95,19,520,6.15
47,East Windsor,2014,5045,559,43,119,14,735,14.57
39,Eastford,2014,793,0,0,24,0,24,3.03
46,Easton,2014,2715,0,0,0,11,11,0.41
48,Ellington,2014,6665,260,9,106,0,375,5.63
49,Enfield,2014,17558,1340,211,581,7,2139,12.18
50,Essex,2014,3261,36,5,12,0,53,1.63
51,Fairfield,2014,21648,241,94,34,116,485,2.24
52,Farmington,2014,11106,496,110,123,155,884,7.96
53,Franklin,2014,771,27,0,16,0,43,5.58
54,Glastonbury,2014,13656,583,37,124,2,746,5.46
55,Goshen,2014,1664,1,0,9,0,10,0.60
56,Granby,2014,4360,85,1,47,5,138,3.17
57,Greenwich,2014,25631,839,334,2,54,1229,4.79
58,Griswold,2014,5118,153,67,237,0,457,8.93
59,Groton,2014,17978,3589,76,369,10,4044,22.49
60,Guilford,2014,9596,177,7,36,0,220,2.29
61,Haddam,2014,3504,22,0,25,0,47,1.34
62,Hamden,2014,25114,903,545,477,4,1929,7.68
63,Hampton,2014,793,0,2,42,0,44,5.55
64,Hartford,2014,51822,10299,7812,1523,0,19634,37.89
65,Hartland,2014,856,2,1,8,0,11,1.29
66,Harwinton,2014,2282,22,0,36,0,58,2.54
67,Hebron,2014,3567,58,3,46,0,107,3.00
68,Kent,2014,1665,52,4,4,0,60,3.60
69,Killingly,2014,7592,495,107,488,0,1090,14.36
70,Killingworth,2014,2598,0,0,11,5,16,0.62
71,Lebanon,2014,3125,26,5,88,0,119,3.81
72,Ledyard,2014,5987,32,5,204,0,241,4.03
73,Lisbon,2014,1730,2,0,57,0,59,3.41
74,Litchfield,2014,3975,140,5,28,29,202,5.08
75,Lyme,2014,1223,0,0,2,8,10,0.82
76,Madison,2014,8049,90,1,10,29,130,1.62
77,Manchester,2014,25996,1834,977,923,36,3770,14.50
78,Mansfield,2014,6017,417,125,117,2,661,10.99
79,Marlborough,2014,2389,24,2,23,0,49,2.05
80,Meriden,2014,25892,2027,1033,1065,11,4136,15.97
81,Middlebury,2014,2892,77,3,15,20,115,3.98
82,Middlefield,2014,1863,30,2,13,1,46,2.47
83,Middletown,2014,21223,2974,1047,614,25,4660,21.96
84,Milford,2014,23074,726,212,220,107,1265,5.48
85,Monroe,2014,6918,32,3,23,1,59,0.85
86,Montville,2014,7407,81,28,240,0,349,4.71
87,Morris,2014,1314,20,4,1,0,25,1.90
88,Naugatuck,2014,13061,537,368,311,0,1216,9.31
89,New Britain,2014,31226,3421,1602,1192,382,6597,21.13
90,New Canaan,2014,7551,163,9,2,31,205,2.71
91,New Fairfield,2014,5593,0,0,27,13,40,0.72
92,New Hartford,2014,2923,12,5,46,15,78,2.67
93,New Haven,2014,54967,8880,5336,1188,581,15985,29.08
95,New London,2014,11840,1685,674,487,98,2944,24.86
96,New Milford,2014,11731,269,27,147,16,459,3.91
94,Newington,2014,13011,537,148,390,36,1111,8.54
97,Newtown,2014,10061,134,3,29,15,181,1.80
98,Norfolk,2014,967,28,2,9,0,39,4.03
99,North Branford,2014,5629,62,10,62,0,134,2.38
100,North Canaan,2014,1587,138,1,8,0,147,9.26
101,North Haven,2014,9491,343,36,76,1,456,4.80
102,North Stonington,2014,2306,0,2,22,0,24,1.04
103,Norwalk,2014,35415,2334,997,261,599,4191,11.83
104,Norwich,2014,18659,2109,721,554,0,3384,18.14
105,Old Lyme,2014,5021,64,2,9,3,78,1.55
106,Old Saybrook,2014,5602,50,7,19,20,96,1.71
107,Orange,2014,5345,46,6,10,6,68,1.27
108,Oxford,2014,4746,36,3,12,0,51,1.07
109,Plainfield,2014,6229,377,166,460,0,1003,16.10
110,Plainville,2014,8063,242,21,311,22,596,7.39
111,Plymouth,2014,5109,178,18,224,0,420,8.22
112,Pomfret,2014,1684,32,1,28,0,61,3.62
113,Portland,2014,4077,185,82,64,0,331,8.12
114,Preston,2014,2019,40,5,44,0,89,4.41
115,Prospect,2014,3474,0,4,38,0,42,1.21
116,Putnam,2014,4299,383,69,208,0,660,15.35
117,Redding,2014,3811,0,0,0,0,0,0.00
118,Ridgefield,2014,9420,179,1,9,48,237,2.52
119,Rocky Hill,2014,8843,235,30,179,0,444,5.02
120,Roxbury,2014,1167,19,0,1,0,20,1.71
121,Salem,2014,1635,1,0,34,0,35,2.14
122,Salisbury,2014,2593,16,2,7,12,37,1.43
123,Scotland,2014,680,0,0,13,0,13,1.91
124,Seymour,2014,6968,262,18,97,0,377,5.41
125,Sharon,2014,1775,20,2,4,0,26,1.46
126,Shelton,2014,16146,344,34,87,82,547,3.39
127,Sherman,2014,1831,0,2,3,0,5,0.27
128,Simsbury,2014,9123,241,19,62,0,322,3.53
129,Somers,2014,3479,146,12,31,0,189,5.43
132,South Windsor,2014,10243,427,49,239,0,715,6.98
130,Southbury,2014,9091,90,4,18,0,112,1.23
131,Southington,2014,17447,609,67,295,51,1022,5.86
133,Sprague,2014,1248,20,13,47,0,80,6.41
134,Stafford,2014,5124,178,13,231,0,422,8.24
135,Stamford,2014,50573,4862,1732,326,1295,8215,16.24
136,Sterling,2014,1511,0,6,61,0,67,4.43
137,Stonington,2014,9467,297,15,71,0,383,4.05
138,Stratford,2014,21091,524,381,278,33,1216,5.77
139,Suffield,2014,5469,212,3,64,15,294,5.38
140,Thomaston,2014,3276,104,4,115,0,223,6.81
141,Thompson,2014,4171,151,25,133,0,309,7.41
142,Tolland,2014,5451,98,2,93,3,196,3.60
143,Torrington,2014,16761,1112,277,639,17,2045,12.20
144,Trumbull,2014,13157,315,15,36,317,683,5.19
145,Union,2014,388,0,0,12,0,12,3.09
146,Vernon,2014,13896,1387,391,374,12,2164,15.57
147,Voluntown,2014,1127,20,4,38,0,62,5.50
148,Wallingford,2014,18945,481,115,310,35,941,4.97
149,Warren,2014,811,0,0,5,0,5,0.62
150,Washington,2014,2124,14,6,7,23,50,2.35
151,Waterbury,2014,47991,5171,3074,2327,326,10898,22.71
152,Waterford,2014,8634,123,20,239,0,382,4.42
153,Watertown,2014,9096,205,18,145,0,368,4.05
155,West Hartford,2014,26396,621,832,316,287,2056,7.79
156,West Haven,2014,22446,1024,1451,429,0,2904,12.94
154,Westbrook,2014,3937,140,7,17,24,188,4.78
157,Weston,2014,3674,0,1,0,0,1,0.03
158,Westport,2014,10399,246,45,2,20,313,3.01
159,Wethersfield,2014,11677,615,134,231,0,980,8.39
160,Willington,2014,2637,160,1,46,0,207,7.85
161,Wilton,2014,6475,136,7,7,100,250,3.86
162,Winchester,2014,5613,348,444,187,0,979,17.44
163,Windham,2014,9570,1862,541,575,0,2978,31.12
164,Windsor,2014,11767,154,297,401,26,878,7.46
165,Windsor Locks,2014,5429,137,153,187,0,477,8.79
166,Wolcott,2014,6276,313,4,131,0,448,7.14
167,Woodbridge,2014,3478,30,5,6,0,41,1.18
168,Woodbury,2014,4564,59,2,25,0,86,1.88
169,Woodstock,2014,3582,24,3,72,0,99,2.76
1,Andover,2013,1317,24,1,29,0,54,4.10
2,Ansonia,2013,8148,371,756,112,9,1248,15.32
3,Ashford,2013,1903,32,2,48,0,82,4.31
4,Avon,2013,7389,244,7,29,0,280,3.79
5,Barkhamsted,2013,1589,0,1,15,0,16,1.01
6,Beacon Falls,2013,2509,0,5,32,0,37,1.47
7,Berlin,2013,8140,556,29,93,6,684,8.40
8,Bethany,2013,2044,0,0,2,1,3,0.15
9,Bethel,2013,7310,252,10,64,63,389,5.32
10,Bethlehem,2013,1575,24,1,1,0,26,1.65
11,Bloomfield,2013,9019,592,147,306,0,1045,11.59
12,Bolton,2013,2015,0,3,20,0,23,1.14
13,Bozrah,2013,1059,0,4,29,0,33,3.12
14,Branford,2013,13972,243,50,179,0,472,3.38
15,Bridgeport,2013,57012,5738,3781,1014,20,10553,18.51
16,Bridgewater,2013,881,0,0,2,0,2,0.23
17,Bristol,2013,27011,1771,798,1065,0,3634,13.45
18,Brookfield,2013,6562,35,7,55,63,160,2.44
19,Brooklyn,2013,3235,232,11,135,0,378,11.68
20,Burlington,2013,3389,28,0,41,0,69,2.04
21,Canaan,2013,779,25,0,10,1,36,4.62
22,Canterbury,2013,2043,76,1,69,0,146,7.15
23,Canton,2013,4339,211,19,63,32,325,7.49
24,Chaplin,2013,988,0,0,28,0,28,2.83
25,Cheshire,2013,10424,237,7,76,17,337,3.23
26,Chester,2013,1923,23,2,13,0,38,1.98
27,Clinton,2013,6065,84,5,48,0,137,2.26
28,Colchester,2013,6182,364,31,125,0,520,8.41
29,Colebrook,2013,722,0,0,8,1,9,1.25
30,Columbia,2013,2308,24,2,60,0,86,3.73
31,Cornwall,2013,1007,18,0,6,0,24,2.38
32,Coventry,2013,5099,104,1,182,20,307,6.02
33,Cromwell,2013,6001,212,6,200,0,418,6.97
34,Danbury,2013,31154,1586,1180,344,295,3405,10.93
35,Darien,2013,7074,83,6,1,95,185,2.62
36,Deep River,2013,2096,26,5,27,0,58,2.77
37,Derby,2013,5849,259,307,68,0,634,10.84
38,Durham,2013,2694,34,1,21,0,56,2.08
40,East Granby,2013,2152,72,4,37,0,113,5.25
41,East Haddam,2013,4508,73,0,42,1,116,2.57
42,East Hampton,2013,5485,70,5,100,25,200,3.65
43,East Hartford,2013,21328,1578,1024,950,0,3552,16.65
44,East Haven,2013,12533,422,128,307,0,857,6.84
45,East Lyme,2013,8458,344,8,102,19,473,5.59
47,East Windsor,2013,5045,558,49,127,14,748,14.83
39,Eastford,2013,793,0,0,25,0,25,3.15
46,Easton,2013,2715,0,0,0,11,11,0.41
48,Ellington,2013,6665,260,8,125,0,393,5.90
49,Enfield,2013,17558,1340,215,581,7,2143,12.21
50,Essex,2013,3261,36,6,13,0,55,1.69
51,Fairfield,2013,21648,241,181,34,116,572,2.64
52,Farmington,2013,11106,469,110,124,155,858,7.73
53,Franklin,2013,771,0,1,20,0,21,2.72
54,Glastonbury,2013,13656,582,47,124,2,755,5.53
55,Goshen,2013,1664,1,0,7,0,8,0.48
56,Granby,2013,4360,85,2,60,5,152,3.49
57,Greenwich,2013,25631,837,421,2,54,1314,5.13
58,Griswold,2013,5118,153,41,222,0,416,8.13
59,Groton,2013,17978,3267,52,361,10,3690,20.53
60,Guilford,2013,9596,168,6,42,0,216,2.25
61,Haddam,2013,3504,22,1,21,0,44,1.26
62,Hamden,2013,25114,685,523,477,4,1689,6.73
63,Hampton,2013,793,0,0,32,0,32,4.04
64,Hartford,2013,51822,9540,8525,1523,0,19588,37.80
65,Hartland,2013,856,2,0,10,0,12,1.40
66,Harwinton,2013,2282,22,0,35,0,57,2.50
67,Hebron,2013,3567,59,3,46,0,108,3.03
68,Kent,2013,1665,24,0,4,0,28,1.68
69,Killingly,2013,7592,530,125,479,0,1134,14.94
70,Killingworth,2013,2598,0,2,10,5,17,0.65
71,Lebanon,2013,3125,26,4,79,0,109,3.49
72,Ledyard,2013,5987,32,6,226,0,264,4.41
73,Lisbon,2013,1730,2,0,64,0,66,3.82
74,Litchfield,2013,3975,140,1,16,29,186,4.68
75,Lyme,2013,1223,0,0,2,8,10,0.82
76,Madison,2013,8049,90,1,10,29,130,1.62
77,Manchester,2013,25996,1833,1074,925,36,3868,14.88
78,Mansfield,2013,6017,417,153,108,2,680,11.30
79,Marlborough,2013,2389,24,0,29,0,53,2.22
80,Meriden,2013,25892,1745,1012,1065,11,3833,14.80
81,Middlebury,2013,2892,76,4,20,8,108,3.73
82,Middlefield,2013,1863,30,1,12,1,44,2.36
83,Middletown,2013,21223,2859,1467,614,25,4965,23.39
84,Milford,2013,23074,822,277,220,107,1426,6.18
85,Monroe,2013,6918,32,1,25,1,59,0.85
86,Montville,2013,7407,81,30,262,0,373,5.04
87,Morris,2013,1314,20,2,1,0,23,1.75
88,Naugatuck,2013,13061,493,293,311,0,1097,8.40
89,New Britain,2013,31226,3266,1627,1192,382,6467,20.71
90,New Canaan,2013,7551,162,10,2,31,205,2.71
91,New Fairfield,2013,5593,0,0,36,13,49,0.88
92,New Hartford,2013,2923,12,1,42,15,70,2.39
93,New Haven,2013,54967,8261,6232,1188,605,16286,29.63
95,New London,2013,11840,1672,144,482,83,2381,20.11
96,New Milford,2013,11731,233,259,172,16,680,5.80
94,Newington,2013,13011,425,105,390,36,956,7.35
97,Newtown,2013,10061,134,2,35,15,186,1.85
98,Norfolk,2013,967,28,0,3,0,31,3.21
99,North Branford,2013,5629,62,7,62,0,131,2.33
100,North Canaan,2013,1587,101,0,8,0,109,6.87
101,North Haven,2013,9491,343,28,76,1,448,4.72
102,North Stonington,2013,2306,0,1,28,0,29,1.26
103,Norwalk,2013,35415,2299,957,261,599,4116,11.62
104,Norwich,2013,18659,1972,728,550,0,3250,17.42
105,Old Lyme,2013,5021,60,1,11,3,75,1.49
106,Old Saybrook,2013,5602,50,5,18,19,92,1.64
107,Orange,2013,5345,46,4,10,6,66,1.23
108,Oxford,2013,4746,36,1,14,0,51,1.07
109,Plainfield,2013,6229,378,224,386,0,988,15.86
110,Plainville,2013,8063,242,25,311,22,600,7.44
111,Plymouth,2013,5109,179,5,179,0,363,7.11
112,Pomfret,2013,1684,32,2,28,0,62,3.68
113,Portland,2013,4077,185,92,62,0,339,8.31
114,Preston,2013,2019,40,4,47,0,91,4.51
115,Prospect,2013,3474,0,4,34,0,38,1.09
116,Putnam,2013,4299,383,79,200,0,662,15.40
117,Redding,2013,3811,0,0,0,0,0,0.00
118,Ridgefield,2013,9420,179,0,9,42,230,2.44
119,Rocky Hill,2013,8843,236,29,179,0,444,5.02
120,Roxbury,2013,1167,19,0,2,0,21,1.80
121,Salem,2013,1635,1,0,34,0,35,2.14
122,Salisbury,2013,2593,16,1,7,10,34,1.31
123,Scotland,2013,680,0,0,16,0,16,2.35
124,Seymour,2013,6968,262,16,103,0,381,5.47
125,Sharon,2013,1775,20,0,4,0,24,1.35
126,Shelton,2013,16146,254,21,87,82,444,2.75
127,Sherman,2013,1831,0,1,3,0,4,0.22
128,Simsbury,2013,9123,241,11,62,0,314,3.44
129,Somers,2013,3479,146,7,29,0,182,5.23
132,South Windsor,2013,10243,427,54,239,0,720,7.03
130,Southbury,2013,9091,89,2,23,0,114,1.25
131,Southington,2013,17447,609,42,295,51,997,5.71
133,Sprague,2013,1248,20,9,35,0,64,5.13
134,Stafford,2013,5124,178,11,198,0,387,7.55
135,Stamford,2013,50573,4863,1631,326,1295,8115,16.05
136,Sterling,2013,1511,0,1,61,0,62,4.10
137,Stonington,2013,9467,296,17,66,0,379,4.00
138,Stratford,2013,21091,524,375,278,33,1210,5.74
139,Suffield,2013,5469,212,0,70,15,297,5.43
140,Thomaston,2013,3276,105,4,117,0,226,6.90
141,Thompson,2013,4171,151,13,159,0,323,7.74
142,Tolland,2013,5451,97,1,110,3,211,3.87
143,Torrington,2013,16761,1112,355,639,17,2123,12.67
144,Trumbull,2013,13157,315,12,36,314,677,5.15
145,Union,2013,388,0,0,16,0,16,4.12
146,Vernon,2013,13896,1387,533,374,12,2306,16.59
147,Voluntown,2013,1127,20,2,31,0,53,4.70
148,Wallingford,2013,18945,482,140,310,35,967,5.10
149,Warren,2013,811,0,0,8,0,8,0.99
150,Washington,2013,2124,14,0,1,23,38,1.79
151,Waterbury,2013,47991,4901,3635,2327,326,11189,23.31
152,Waterford,2013,8634,123,17,250,0,390,4.52
153,Watertown,2013,9096,206,24,145,0,375,4.12
155,West Hartford,2013,26396,590,943,316,287,2136,8.09
156,West Haven,2013,22446,1024,1613,429,0,3066,13.66
154,Westbrook,2013,3937,140,8,15,24,187,4.75
157,Weston,2013,3674,0,1,0,0,1,0.03
158,Westport,2013,10399,245,20,2,19,286,2.75
159,Wethersfield,2013,11677,625,127,231,0,983,8.42
160,Willington,2013,2637,160,2,50,0,212,8.04
161,Wilton,2013,6475,135,5,7,100,247,3.81
162,Winchester,2013,5613,316,269,150,0,735,13.09
163,Windham,2013,9570,1752,533,490,0,2775,29.00
164,Windsor,2013,11767,154,282,399,26,861,7.32
165,Windsor Locks,2013,5429,137,178,187,0,502,9.25
166,Wolcott,2013,6276,312,3,131,0,446,7.11
167,Woodbridge,2013,3478,30,3,6,0,39,1.12
168,Woodbury,2013,4564,60,4,25,0,89,1.95
169,Woodstock,2013,3582,24,3,87,0,114,3.18
1,Andover,2012,1317,24,1,22,0,47,3.57
2,Ansonia,2012,8148,372,699,106,9,1186,14.56
3,Ashford,2012,1903,32,2,37,0,71,3.73
4,Avon,2012,7389,240,7,23,0,270,3.65
5,Barkhamsted,2012,1589,0,1,12,0,13,0.82
6,Beacon Falls,2012,2509,0,5,26,0,31,1.24
7,Berlin,2012,8140,468,29,82,6,585,7.19
8,Bethany,2012,2044,0,0,1,1,2,0.10
9,Bethel,2012,7310,250,10,57,63,380,5.20
10,Bethlehem,2012,1575,24,1,0,0,25,1.59
11,Bloomfield,2012,9019,584,147,295,0,1026,11.38
12,Bolton,2012,2015,0,3,16,0,19,0.94
13,Bozrah,2012,1059,0,4,19,0,23,2.17
14,Branford,2012,13972,232,50,174,0,456,3.26
15,Bridgeport,2012,57012,5604,3498,964,20,10086,17.69
16,Bridgewater,2012,881,0,0,2,0,2,0.23
17,Bristol,2012,27011,1771,793,1014,0,3578,13.25
18,Brookfield,2012,6562,35,7,42,55,139,2.12
19,Brooklyn,2012,3235,233,11,80,0,324,10.02
20,Burlington,2012,3389,28,0,29,0,57,1.68
21,Canaan,2012,779,25,0,9,1,35,4.49
22,Canterbury,2012,2043,76,1,40,0,117,5.73
23,Canton,2012,4339,211,19,55,32,317,7.31
24,Chaplin,2012,988,0,0,24,0,24,2.43
25,Cheshire,2012,10424,237,7,70,17,331,3.18
26,Chester,2012,1923,23,2,10,0,35,1.82
27,Clinton,2012,6065,84,5,43,0,132,2.18
28,Colchester,2012,6182,364,31,93,0,488,7.89
29,Colebrook,2012,722,0,0,7,1,8,1.11
30,Columbia,2012,2308,24,2,43,0,69,2.99
31,Cornwall,2012,1007,18,0,2,0,20,1.99
32,Coventry,2012,5099,104,1,136,20,261,5.12
33,Cromwell,2012,6001,212,6,199,0,417,6.95
34,Danbury,2012,31154,1586,1181,315,192,3274,10.51
35,Darien,2012,7074,83,6,1,93,183,2.59
36,Deep River,2012,2096,26,5,23,0,54,2.58
37,Derby,2012,5849,259,307,63,0,629,10.75
38,Durham,2012,2694,33,1,13,0,47,1.74
40,East Granby,2012,2152,72,4,32,0,108,5.02
41,East Haddam,2012,4508,73,0,30,1,104,2.31
42,East Hampton,2012,5485,70,5,76,25,176,3.21
43,East Hartford,2012,21328,1577,1024,908,0,3509,16.45
44,East Haven,2012,12533,421,128,294,0,843,6.73
45,East Lyme,2012,8458,342,8,80,19,449,5.31
47,East Windsor,2012,5045,558,49,100,14,721,14.29
39,Eastford,2012,793,0,0,19,0,19,2.40
46,Easton,2012,2715,0,0,0,11,11,0.41
48,Ellington,2012,6665,260,8,83,0,351,5.27
49,Enfield,2012,17558,1340,215,546,7,2108,12.01
50,Essex,2012,3261,36,6,9,0,51,1.56
51,Fairfield,2012,21648,241,181,29,116,567,2.62
52,Farmington,2012,11106,456,110,117,155,838,7.55
53,Franklin,2012,771,0,1,16,0,17,2.20
54,Glastonbury,2012,13656,582,47,122,2,753,5.51
55,Goshen,2012,1664,1,0,5,0,6,0.36
56,Granby,2012,4360,85,2,42,5,134,3.07
57,Greenwich,2012,25631,837,421,2,54,1314,5.13
58,Griswold,2012,5118,136,41,159,0,336,6.57
59,Groton,2012,17978,3267,52,337,10,3666,20.39
60,Guilford,2012,9596,168,6,29,0,203,2.12
61,Haddam,2012,3504,22,1,15,0,38,1.08
62,Hamden,2012,25114,684,523,448,4,1659,6.61
63,Hampton,2012,793,0,0,18,0,18,2.27
64,Hartford,2012,51822,9415,8390,1440,0,19245,37.14
65,Hartland,2012,856,2,0,6,0,8,0.93
66,Harwinton,2012,2282,23,0,25,0,48,2.10
67,Hebron,2012,3567,59,3,36,0,98,2.75
68,Kent,2012,1665,48,0,4,0,52,3.12
69,Killingly,2012,7592,530,120,309,0,959,12.63
70,Killingworth,2012,2598,0,2,5,5,12,0.46
71,Lebanon,2012,3125,26,4,56,0,86,2.75
72,Ledyard,2012,5987,32,6,168,0,206,3.44
73,Lisbon,2012,1730,2,0,43,0,45,2.60
74,Litchfield,2012,3975,140,1,12,29,182,4.58
75,Lyme,2012,1223,0,0,2,8,10,0.82
76,Madison,2012,8049,90,1,8,29,128,1.59
77,Manchester,2012,25996,1813,1074,884,36,3807,14.64
78,Mansfield,2012,6017,417,153,86,2,658,10.94
79,Marlborough,2012,2389,24,0,20,0,44,1.84
80,Meriden,2012,25892,1769,1008,1022,11,3810,14.71
81,Middlebury,2012,2892,76,4,12,8,100,3.46
82,Middlefield,2012,1863,30,1,10,1,42,2.25
83,Middletown,2012,21223,2814,987,590,25,4416,20.81
84,Milford,2012,23074,822,277,212,85,1396,6.05
85,Monroe,2012,6918,35,1,19,1,56,0.81
86,Montville,2012,7407,81,30,201,0,312,4.21
87,Morris,2012,1314,20,2,0,0,22,1.67
88,Naugatuck,2012,13061,492,293,301,0,1086,8.31
89,New Britain,2012,31226,3183,1627,1153,382,6345,20.32
90,New Canaan,2012,7551,140,10,2,31,183,2.42
91,New Fairfield,2012,5593,0,0,25,13,38,0.68
92,New Hartford,2012,2923,12,1,38,15,66,2.26
93,New Haven,2012,54967,8210,6138,1127,545,16020,29.14
95,New London,2012,11840,1672,144,457,83,2356,19.90
96,New Milford,2012,11731,233,259,123,16,631,5.38
94,Newington,2012,13011,426,105,366,36,933,7.17
97,Newtown,2012,10061,134,2,23,15,174,1.73
98,Norfolk,2012,967,28,0,3,0,31,3.21
99,North Branford,2012,5629,62,7,55,0,124,2.20
100,North Canaan,2012,1587,101,0,7,0,108,6.81
101,North Haven,2012,9491,343,28,74,1,446,4.70
102,North Stonington,2012,2306,0,1,21,0,22,0.95
103,Norwalk,2012,35415,2248,947,238,616,4049,11.43
104,Norwich,2012,18659,1906,728,518,0,3152,16.89
105,Old Lyme,2012,5021,60,1,7,3,71,1.41
106,Old Saybrook,2012,5602,50,5,16,1,72,1.29
107,Orange,2012,5345,46,4,9,0,59,1.10
108,Oxford,2012,4746,36,1,8,0,45,0.95
109,Plainfield,2012,6229,378,224,296,0,898,14.42
110,Plainville,2012,8063,223,25,302,21,571,7.08
111,Plymouth,2012,5109,179,5,152,0,336,6.58
112,Pomfret,2012,1684,32,2,17,0,51,3.03
113,Portland,2012,4077,185,92,51,0,328,8.05
114,Preston,2012,2019,40,4,36,0,80,3.96
115,Prospect,2012,3474,0,4,25,0,29,0.83
116,Putnam,2012,4299,383,73,133,0,589,13.70
117,Redding,2012,3811,0,0,0,0,0,0.00
118,Ridgefield,2012,9420,179,0,8,33,220,2.34
119,Rocky Hill,2012,8843,236,29,173,0,438,4.95
120,Roxbury,2012,1167,19,0,1,0,20,1.71
121,Salem,2012,1635,1,0,28,0,29,1.77
122,Salisbury,2012,2593,16,1,5,10,32,1.23
123,Scotland,2012,680,0,0,11,0,11,1.62
124,Seymour,2012,6968,262,16,89,0,367,5.27
125,Sharon,2012,1775,20,0,4,0,24,1.35
126,Shelton,2012,16146,254,21,83,82,440,2.73
127,Sherman,2012,1831,0,1,1,0,2,0.11
128,Simsbury,2012,9123,241,11,58,0,310,3.40
129,Somers,2012,3479,54,7,18,0,79,2.27
132,South Windsor,2012,10243,427,54,235,0,716,6.99
130,Southbury,2012,9091,89,2,14,0,105,1.15
131,Southington,2012,17447,609,42,281,51,983,5.63
133,Sprague,2012,1248,20,9,31,0,60,4.81
134,Stafford,2012,5124,178,11,160,0,349,6.81
135,Stamford,2012,50573,4618,1605,309,1295,7827,15.48
136,Sterling,2012,1511,0,1,35,0,36,2.38
137,Stonington,2012,9467,296,17,52,0,365,3.86
138,Stratford,2012,21091,524,375,259,33,1191,5.65
139,Suffield,2012,5469,212,0,52,15,279,5.10
140,Thomaston,2012,3276,105,4,91,0,200,6.11
141,Thompson,2012,4171,150,13,83,0,246,5.90
142,Tolland,2012,5451,97,1,79,3,180,3.30
143,Torrington,2012,16761,1082,297,611,17,2007,11.97
144,Trumbull,2012,13157,315,12,35,314,676,5.14
145,Union,2012,388,0,0,9,0,9,2.32
146,Vernon,2012,13896,1386,533,352,12,2283,16.43
147,Voluntown,2012,1127,20,2,23,0,45,3.99
148,Wallingford,2012,18945,482,140,298,35,955,5.04
149,Warren,2012,811,0,0,4,0,4,0.49
150,Washington,2012,2124,14,0,0,23,37,1.74
151,Waterbury,2012,47991,4870,3149,2256,326,10601,22.09
152,Waterford,2012,8634,123,17,208,0,348,4.03
153,Watertown,2012,9096,206,24,134,0,364,4.00
155,West Hartford,2012,26396,541,943,304,287,2075,7.86
156,West Haven,2012,22446,1024,1503,415,0,2942,13.11
154,Westbrook,2012,3937,140,8,13,24,185,4.70
157,Weston,2012,3674,0,1,0,0,1,0.03
158,Westport,2012,10399,245,20,2,15,282,2.71
159,Wethersfield,2012,11677,625,127,216,0,968,8.29
160,Willington,2012,2637,160,2,37,0,199,7.55
161,Wilton,2012,6475,84,5,7,140,236,3.64
162,Winchester,2012,5613,316,269,122,0,707,12.60
163,Windham,2012,9570,1692,436,448,0,2576,26.92
164,Windsor,2012,11767,154,282,379,26,841,7.15
165,Windsor Locks,2012,5429,137,178,182,0,497,9.15
166,Wolcott,2012,6276,312,3,121,0,436,6.95
167,Woodbridge,2012,3478,30,3,6,0,39,1.12
168,Woodbury,2012,4564,60,4,19,0,83,1.82
169,Woodstock,2012,3582,24,3,52,0,79,2.21
1,Andover,2011,1317,24,1,20,0,45,3.42
2,Ansonia,2011,8148,372,699,106,9,1186,14.56
3,Ashford,2011,1903,32,1,35,0,68,3.57
4,Avon,2011,7389,240,5,21,0,266,3.60
5,Barkhamsted,2011,1589,0,3,11,0,14,0.88
6,Beacon Falls,2011,2509,0,6,25,0,31,1.24
7,Berlin,2011,8140,468,30,82,6,586,7.20
8,Bethany,2011,2044,0,0,1,0,1,0.05
9,Bethel,2011,7310,250,9,57,63,379,5.18
10,Bethlehem,2011,1575,24,0,0,0,24,1.52
11,Bloomfield,2011,9019,584,147,295,0,1026,11.38
12,Bolton,2011,2015,0,3,15,0,18,0.89
13,Bozrah,2011,1059,0,4,16,0,20,1.89
14,Branford,2011,13972,232,46,174,0,452,3.24
15,Bridgeport,2011,57012,5604,3724,964,15,10307,18.08
16,Bridgewater,2011,881,0,0,2,0,2,0.23
17,Bristol,2011,27011,1771,791,1014,0,3576,13.24
18,Brookfield,2011,6562,35,6,38,52,131,2.00
19,Brooklyn,2011,3235,233,9,63,0,305,9.43
20,Burlington,2011,3389,28,0,25,0,53,1.56
21,Canaan,2011,779,25,0,9,1,35,4.49
22,Canterbury,2011,2043,76,1,31,0,108,5.29
23,Canton,2011,4339,211,20,52,32,315,7.26
24,Chaplin,2011,988,0,1,23,0,24,2.43
25,Cheshire,2011,10424,237,5,70,17,329,3.16
26,Chester,2011,1923,23,2,9,0,34,1.77
27,Clinton,2011,6065,84,5,42,0,131,2.16
28,Colchester,2011,6182,364,26,84,0,474,7.67
29,Colebrook,2011,722,0,0,7,1,8,1.11
30,Columbia,2011,2308,24,4,37,0,65,2.82
31,Cornwall,2011,1007,18,0,0,0,18,1.79
32,Coventry,2011,5099,104,5,116,20,245,4.80
33,Cromwell,2011,6001,212,6,199,0,417,6.95
34,Danbury,2011,31154,1586,952,315,273,3126,10.03
35,Darien,2011,7074,83,8,1,93,185,2.62
36,Deep River,2011,2096,26,4,22,0,52,2.48
37,Derby,2011,5849,259,305,63,0,627,10.72
38,Durham,2011,2694,33,1,11,0,45,1.67
40,East Granby,2011,2152,72,1,30,0,103,4.79
41,East Haddam,2011,4508,73,3,27,1,104,2.31
42,East Hampton,2011,5485,70,1,69,25,165,3.01
43,East Hartford,2011,21328,1577,835,908,0,3320,15.57
44,East Haven,2011,12533,421,254,294,0,969,7.73
45,East Lyme,2011,8458,342,61,78,10,491,5.81
47,East Windsor,2011,5045,558,27,92,14,691,13.70
39,Eastford,2011,793,0,0,16,0,16,2.02
46,Easton,2011,2715,0,33,0,11,44,1.62
48,Ellington,2011,6665,260,6,69,0,335,5.03
49,Enfield,2011,17558,1340,215,546,7,2108,12.01
50,Essex,2011,3261,36,4,8,0,48,1.47
51,Fairfield,2011,21648,241,182,29,117,569,2.63
52,Farmington,2011,11106,456,110,117,154,837,7.54
53,Franklin,2011,771,0,1,15,0,16,2.08
54,Glastonbury,2011,13656,582,49,122,0,753,5.51
55,Goshen,2011,1664,1,1,5,0,7,0.42
56,Granby,2011,4360,85,1,34,5,125,2.87
57,Greenwich,2011,25631,837,359,2,54,1252,4.88
58,Griswold,2011,5118,136,42,140,0,318,6.21
59,Groton,2011,17978,3267,56,337,10,3670,20.41
60,Guilford,2011,9596,168,5,28,0,201,2.09
61,Haddam,2011,3504,22,1,14,0,37,1.06
62,Hamden,2011,25114,684,514,448,4,1650,6.57
63,Hampton,2011,793,0,0,16,0,16,2.02
64,Hartford,2011,51822,9415,7577,1440,0,18432,35.57
65,Hartland,2011,856,2,0,4,0,6,0.70
66,Harwinton,2011,2282,23,1,21,0,45,1.97
67,Hebron,2011,3567,59,3,30,0,92,2.58
68,Kent,2011,1665,48,1,4,24,77,4.62
69,Killingly,2011,7592,530,124,251,0,905,11.92
70,Killingworth,2011,2598,0,1,5,5,11,0.42
71,Lebanon,2011,3125,26,5,47,0,78,2.50
72,Ledyard,2011,5987,32,7,158,0,197,3.29
73,Lisbon,2011,1730,2,0,35,0,37,2.14
74,Litchfield,2011,3975,140,2,11,29,182,4.58
75,Lyme,2011,1223,0,0,2,7,9,0.74
76,Madison,2011,8049,90,1,7,29,127,1.58
77,Manchester,2011,25996,1813,1011,883,36,3743,14.40
78,Mansfield,2011,6017,417,159,76,2,654,10.87
79,Marlborough,2011,2389,24,0,16,0,40,1.67
80,Meriden,2011,25892,1769,970,1022,11,3772,14.57
81,Middlebury,2011,2892,76,3,8,8,95,3.28
82,Middlefield,2011,1863,30,0,10,1,41,2.20
83,Middletown,2011,21223,2814,1295,590,25,4724,22.26
84,Milford,2011,23074,822,285,212,85,1404,6.08
85,Monroe,2011,6918,35,1,18,1,55,0.80
86,Montville,2011,7407,81,30,177,0,288,3.89
87,Morris,2011,1314,20,2,0,0,22,1.67
88,Naugatuck,2011,13061,492,273,301,0,1066,8.16
89,New Britain,2011,31226,3183,1457,1153,396,6189,19.82
90,New Canaan,2011,7551,140,10,2,31,183,2.42
91,New Fairfield,2011,5593,0,0,22,13,35,0.63
92,New Hartford,2011,2923,12,0,36,15,63,2.16
93,New Haven,2011,54967,8210,6116,1127,487,15940,29.00
95,New London,2011,11840,1672,155,457,69,2353,19.87
96,New Milford,2011,11731,233,221,107,16,577,4.92
94,Newington,2011,13011,426,84,366,36,912,7.01
97,Newtown,2011,10061,134,4,20,15,173,1.72
98,Norfolk,2011,967,28,0,3,0,31,3.21
99,North Branford,2011,5629,62,8,52,0,122,2.17
100,North Canaan,2011,1587,101,0,7,0,108,6.81
101,North Haven,2011,9491,343,29,74,1,447,4.71
102,North Stonington,2011,2306,0,1,17,0,18,0.78
103,Norwalk,2011,35415,2248,982,238,559,4027,11.37
104,Norwich,2011,18659,1906,707,517,0,3130,16.77
105,Old Lyme,2011,5021,60,1,5,3,69,1.37
106,Old Saybrook,2011,5602,50,5,15,1,71,1.27
107,Orange,2011,5345,46,4,9,0,59,1.10
108,Oxford,2011,4746,36,1,8,0,45,0.95
109,Plainfield,2011,6229,378,225,261,0,864,13.87
110,Plainville,2011,8063,223,24,302,53,602,7.47
111,Plymouth,2011,5109,179,5,142,0,326,6.38
112,Pomfret,2011,1684,32,2,11,0,45,2.67
113,Portland,2011,4077,185,91,48,0,324,7.95
114,Preston,2011,2019,40,3,34,0,77,3.81
115,Prospect,2011,3474,0,4,22,0,26,0.75
116,Putnam,2011,4299,383,64,101,0,548,12.75
117,Redding,2011,3811,0,0,0,0,0,0.00
118,Ridgefield,2011,9420,179,0,8,20,207,2.20
119,Rocky Hill,2011,8843,236,23,173,0,432,4.89
120,Roxbury,2011,1167,19,0,1,0,20,1.71
121,Salem,2011,1635,1,0,25,0,26,1.59
122,Salisbury,2011,2593,16,0,4,10,30,1.16
123,Scotland,2011,680,0,0,9,0,9,1.32
124,Seymour,2011,6968,262,25,83,0,370,5.31
125,Sharon,2011,1775,20,1,4,0,25,1.41
126,Shelton,2011,16146,254,16,83,82,435,2.69
127,Sherman,2011,1831,0,1,1,0,2,0.11
128,Simsbury,2011,9123,241,12,58,0,311,3.41
129,Somers,2011,3479,54,7,16,0,77,2.21
132,South Windsor,2011,10243,427,53,235,0,715,6.98
130,Southbury,2011,9091,89,2,12,0,103,1.13
131,Southington,2011,17447,609,41,281,51,982,5.63
133,Sprague,2011,1248,20,9,30,0,59,4.73
134,Stafford,2011,5124,178,12,140,0,330,6.44
135,Stamford,2011,50573,4618,1645,309,1221,7793,15.41
136,Sterling,2011,1511,0,3,21,9,33,2.18
137,Stonington,2011,9467,296,16,49,0,361,3.81
138,Stratford,2011,21091,524,365,259,33,1181,5.60
139,Suffield,2011,5469,212,0,41,15,268,4.90
140,Thomaston,2011,3276,105,3,83,0,191,5.83
141,Thompson,2011,4171,150,12,54,0,216,5.18
142,Tolland,2011,5451,97,2,69,3,171,3.14
143,Torrington,2011,16761,1082,301,611,17,2011,12.00
144,Trumbull,2011,13157,315,13,35,274,637,4.84
145,Union,2011,388,0,0,6,0,6,1.55
146,Vernon,2011,13896,1386,519,352,12,2269,16.33
147,Voluntown,2011,1127,20,2,21,0,43,3.82
148,Wallingford,2011,18945,482,141,299,35,957,5.05
149,Warren,2011,811,0,0,2,0,2,0.25
150,Washington,2011,2124,14,0,0,23,37,1.74
151,Waterbury,2011,47991,4870,3110,2256,333,10569,22.02
152,Waterford,2011,8634,123,13,192,0,328,3.80
153,Watertown,2011,9096,206,19,134,0,359,3.95
155,West Hartford,2011,26396,541,942,304,282,2069,7.84
156,West Haven,2011,22446,1024,1380,415,0,2819,12.56
154,Westbrook,2011,3937,140,7,13,24,184,4.67
157,Weston,2011,3674,0,1,0,0,1,0.03
158,Westport,2011,10399,245,20,2,15,282,2.71
159,Wethersfield,2011,11677,625,127,216,0,968,8.29
160,Willington,2011,2637,160,4,32,0,196,7.43
161,Wilton,2011,6475,84,4,7,70,165,2.55
162,Winchester,2011,5613,316,248,116,0,680,12.11
163,Windham,2011,9570,1692,560,427,0,2679,27.99
164,Windsor,2011,11767,154,245,379,0,778,6.61
165,Windsor Locks,2011,5429,137,149,182,0,468,8.62
166,Wolcott,2011,6276,312,4,121,0,437,6.96
167,Woodbridge,2011,3478,30,5,6,0,41,1.18
168,Woodbury,2011,4564,60,4,19,0,83,1.82
169,Woodstock,2011,3582,24,3,39,0,66,1.84
1,Andover,2021,1317,24,1,29,0,54,4.10
2,Ansonia,2021,8148,366,799,138,0,1303,15.99
3,Ashford,2021,1903,32,0,32,0,64,3.36
4,Avon,2021,7389,244,21,36,1,302,4.09
5,Barkhamsted,2021,1589,0,5,21,0,26,1.64
6,Beacon Falls,2021,2509,0,4,38,0,42,1.67
7,Berlin,2021,8140,556,50,124,4,734,9.02
8,Bethany,2021,2044,0,2,11,0,13,0.64
9,Bethel,2021,7310,192,30,132,87,441,6.03
10,Bethlehem,2021,1575,24,0,5,0,29,1.84
11,Bloomfield,2021,9019,574,114,303,0,991,10.99
12,Bolton,2021,2015,0,2,29,0,31,1.54
13,Bozrah,2021,1059,0,3,27,0,30,2.83
14,Branford,2021,13972,243,73,152,9,477,3.41
15,Bridgeport,2021,57012,6949,4351,815,19,12134,21.28
16,Bridgewater,2021,881,0,0,1,0,1,0.11
17,Bristol,2021,27011,2006,950,1031,0,3987,14.76
18,Brookfield,2021,6562,155,22,97,77,351,5.35
19,Brooklyn,2021,3235,232,10,63,0,305,9.43
20,Burlington,2021,3389,27,0,44,0,71,2.10
21,Canaan,2021,779,1,3,4,1,9,1.16
22,Canterbury,2021,2043,76,1,61,0,138,6.75
23,Canton,2021,4339,251,31,48,32,362,8.34
24,Chaplin,2021,988,0,2,35,0,37,3.74
25,Cheshire,2021,10424,258,23,88,17,386,3.70
26,Chester,2021,1923,23,4,15,0,42,2.18
27,Clinton,2021,6065,105,8,60,0,173,2.85
28,Colchester,2021,6182,364,37,132,4,537,8.69
29,Colebrook,2021,722,0,1,6,1,8,1.11
30,Columbia,2021,2308,24,2,57,0,83,3.60
31,Cornwall,2021,1007,28,2,6,0,36,3.57
32,Coventry,2021,5099,103,4,120,20,247,4.84
33,Cromwell,2021,6001,212,9,173,0,394,6.57
34,Danbury,2021,31154,1652,1258,465,221,3596,11.54
35,Darien,2021,7074,161,14,2,104,281,3.97
36,Deep River,2021,2096,26,6,32,0,64,3.05
37,Derby,2021,5849,275,314,102,0,691,11.81
38,Durham,2021,2694,36,1,26,0,63,2.34
40,East Granby,2021,2152,72,2,42,0,116,5.39
41,East Haddam,2021,4508,73,2,59,0,134,2.97
42,East Hampton,2021,5485,64,7,83,25,179,3.26
43,East Hartford,2021,21328,1593,809,964,0,3366,15.78
44,East Haven,2021,12533,542,167,274,0,983,7.84
45,East Lyme,2021,8458,396,19,86,19,520,6.15
47,East Windsor,2021,5045,559,37,102,0,698,13.84
39,Eastford,2021,793,0,0,10,0,10,1.26
46,Easton,2021,2715,0,0,3,15,18,0.66
48,Ellington,2021,6665,260,5,104,0,369,5.54
49,Enfield,2021,17558,1360,221,592,7,2180,12.42
50,Essex,2021,3261,75,2,16,16,109,3.34
51,Fairfield,2021,21648,231,139,56,182,608,2.81
52,Farmington,2021,11106,470,115,128,155,868,7.82
53,Franklin,2021,771,27,2,19,0,48,6.23
54,Glastonbury,2021,13656,604,49,108,2,763,5.59
55,Goshen,2021,1664,1,1,4,0,6,0.36
56,Granby,2021,4360,85,2,46,5,138,3.17
57,Greenwich,2021,25631,879,458,13,38,1388,5.42
58,Griswold,2021,5118,222,57,144,0,423,8.26
59,Groton,2021,17978,3727,103,335,10,4175,23.22
60,Guilford,2021,9596,186,10,32,0,228,2.38
61,Haddam,2021,3504,22,1,27,0,50,1.43
62,Hamden,2021,25114,1048,818,473,4,2343,9.33
63,Hampton,2021,793,0,1,11,0,12,1.51
64,Hartford,2021,51822,10733,8723,1441,0,20897,40.32
65,Hartland,2021,856,2,0,6,0,8,0.93
66,Harwinton,2021,2282,22,6,34,5,67,2.94
67,Hebron,2021,3567,58,3,44,0,105,2.94
68,Kent,2021,1665,58,4,4,0,66,3.96
69,Killingly,2021,7592,467,152,167,0,786,10.35
70,Killingworth,2021,2598,0,0,16,5,21,0.81
71,Lebanon,2021,3125,26,3,76,0,105,3.36
72,Ledyard,2021,5987,32,12,210,6,260,4.34
73,Lisbon,2021,1730,2,0,58,0,60,3.47
74,Litchfield,2021,3975,140,3,30,19,192,4.83
75,Lyme,2021,1223,0,0,5,8,13,1.06
76,Madison,2021,8049,90,3,9,33,135,1.68
77,Manchester,2021,25996,1871,979,872,32,3754,14.44
78,Mansfield,2021,6017,175,128,80,2,385,6.40
79,Marlborough,2021,2389,24,0,24,0,48,2.01
80,Meriden,2021,25892,1976,1360,956,11,4303,16.62
81,Middlebury,2021,2892,77,5,18,20,120,4.15
82,Middlefield,2021,1863,30,3,18,1,52,2.79
83,Middletown,2021,21223,3116,1129,486,25,4756,22.41
84,Milford,2021,23074,728,244,168,74,1214,5.26
85,Monroe,2021,6918,35,5,44,8,92,1.33
86,Montville,2021,7407,81,54,247,0,382,5.16
87,Morris,2021,1314,20,3,5,0,28,2.13
88,Naugatuck,2021,13061,493,305,344,0,1142,8.74
89,New Britain,2021,31226,3017,1583,1109,100,5809,18.60
90,New Canaan,2021,7551,175,19,5,21,220,2.91
91,New Fairfield,2021,5593,0,2,53,17,72,1.29
92,New Hartford,2021,2923,12,3,47,15,77,2.63
93,New Haven,2021,54967,9652,7142,891,457,18142,33.01
95,New London,2021,11840,1600,490,475,101,2666,22.52
96,New Milford,2021,11731,319,41,153,20,533,4.54
94,Newington,2021,13011,531,128,437,36,1132,8.70
97,Newtown,2021,10061,134,7,80,32,253,2.51
98,Norfolk,2021,967,21,1,5,0,27,2.79
99,North Branford,2021,5629,62,14,45,0,121,2.15
100,North Canaan,2021,1587,148,0,14,0,162,10.21
101,North Haven,2021,9491,393,51,85,23,552,5.82
102,North Stonington,2021,2306,0,1,21,6,28,1.21
103,Norwalk,2021,35415,2245,1546,385,667,4843,13.67
104,Norwich,2021,18659,2296,796,516,0,3608,19.34
105,Old Lyme,2021,5021,64,2,14,3,83,1.65
106,Old Saybrook,2021,5602,52,15,21,73,161,2.87
107,Orange,2021,5345,46,10,10,6,72,1.35
108,Oxford,2021,4746,36,3,26,0,65,1.37
109,Plainfield,2021,6229,377,196,191,4,768,12.33
110,Plainville,2021,8063,205,46,282,22,555,6.88
111,Plymouth,2021,5109,178,20,174,0,372,7.28
112,Pomfret,2021,1684,32,2,13,0,47,2.79
113,Portland,2021,4077,185,90,64,0,339,8.31
114,Preston,2021,2019,40,5,38,0,83,4.11
115,Prospect,2021,3474,0,4,43,45,92,2.65
116,Putnam,2021,4299,413,63,70,0,546,12.70
117,Redding,2021,3811,0,2,15,0,17,0.45
118,Ridgefield,2021,9420,175,6,26,79,286,3.04
119,Rocky Hill,2021,8843,235,62,157,0,454,5.13
120,Roxbury,2021,1167,19,0,5,0,24,2.06
121,Salem,2021,1635,0,4,30,0,34,2.08
122,Salisbury,2021,2593,24,0,2,14,40,1.54
123,Scotland,2021,680,0,1,28,0,29,4.26
124,Seymour,2021,6968,262,29,98,0,389,5.58
125,Sharon,2021,1775,32,1,3,0,36,2.03
126,Shelton,2021,16146,254,40,118,82,494,3.06
127,Sherman,2021,1831,0,1,6,0,7,0.38
128,Simsbury,2021,9123,289,63,86,0,438,4.80
129,Somers,2021,3479,146,7,33,0,186,5.35
132,South Windsor,2021,10243,443,57,186,12,698,6.81
130,Southbury,2021,9091,90,7,31,0,128,1.41
131,Southington,2021,17447,499,62,317,54,932,5.34
133,Sprague,2021,1248,20,12,24,1,57,4.57
134,Stafford,2021,5124,257,20,115,0,392,7.65
135,Stamford,2021,50573,4219,2073,383,1270,7945,15.71
136,Sterling,2021,1511,0,6,21,0,27,1.79
137,Stonington,2021,9467,441,19,79,2,541,5.71
138,Stratford,2021,21091,524,425,344,33,1326,6.29
139,Suffield,2021,5469,296,6,48,15,365,6.67
140,Thomaston,2021,3276,104,5,97,0,206,6.29
141,Thompson,2021,4171,151,13,42,0,206,4.94
142,Tolland,2021,5451,127,12,95,3,237,4.35
143,Torrington,2021,16761,912,328,513,17,1770,10.56
144,Trumbull,2021,13157,315,19,82,315,731,5.56
145,Union,2021,388,0,0,6,0,6,1.55
146,Vernon,2021,13896,1509,470,348,12,2339,16.83
147,Voluntown,2021,1127,20,1,22,0,43,3.82
148,Wallingford,2021,18945,354,142,296,35,827,4.37
149,Warren,2021,811,0,0,1,0,1,0.12
150,Washington,2021,2124,17,2,3,23,45,2.12
151,Waterbury,2021,47991,5385,3156,1597,48,10186,21.22
152,Waterford,2021,8634,213,33,239,0,485,5.62
153,Watertown,2021,9096,205,33,216,0,454,4.99
155,West Hartford,2021,26396,643,852,320,250,2065,7.82
156,West Haven,2021,22446,1024,2119,395,0,3538,15.76
154,Westbrook,2021,3937,140,5,29,29,203,5.16
157,Weston,2021,3674,0,2,6,0,8,0.22
158,Westport,2021,10399,265,60,2,63,390,3.75
159,Wethersfield,2021,11677,705,109,258,0,1072,9.18
160,Willington,2021,2637,160,6,35,0,201,7.62
161,Wilton,2021,6475,158,9,14,51,232,3.58
162,Winchester,2021,5613,350,170,84,0,604,10.76
163,Windham,2021,9570,1776,597,338,0,2711,28.33
164,Windsor,2021,11767,154,288,420,26,888,7.55
165,Windsor Locks,2021,5429,297,154,224,0,675,12.43
166,Wolcott,2021,6276,313,14,174,0,501,7.98
167,Woodbridge,2021,3478,30,8,3,0,41,1.18
168,Woodbury,2021,4564,60,4,27,0,91,1.99
169,Woodstock,2021,3582,24,0,28,0,52,1.45
